//MAP CONVERTED BY dmm2tgm.py THIS HEADER COMMENT PREVENTS RECONVERSION, DO NOT REMOVE
"ad" = (
/obj/structure/table/wood,
/obj/item/seeds/tobacco/space,
/obj/item/seeds/peanut{
	pixel_y = 9;
	pixel_x = 5
	},
/obj/item/seeds/odious_puffball{
	pixel_x = -9;
	pixel_y = 6
	},
/obj/item/seeds/greenbean{
	pixel_y = -3;
	pixel_x = -7
	},
/turf/open/indestructible/hotelwood,
/area/shuttle/blackmarket_chevvy)
"cL" = (
/obj/structure/table/wood,
/obj/item/fishing_rod/master,
/obj/item/fishing_rod/master{
	pixel_y = 8;
	pixel_x = 3
	},
/obj/item/fishing_line/bouncy{
	pixel_y = 13;
	pixel_x = -9
	},
/turf/open/indestructible/hotelwood,
/area/shuttle/blackmarket_chevvy)
"en" = (
/obj/structure/table/wood,
/obj/item/clothing/suit/armor/elder_atmosian{
	pixel_x = 6
	},
/obj/item/clothing/suit/armor/bone{
	pixel_y = 14;
	pixel_x = 4
	},
/obj/item/clothing/suit/armor/vest/cuirass{
	pixel_x = -8;
	pixel_y = 6
	},
/obj/item/clothing/suit/armor/vest/cuirass{
	pixel_x = -6
	},
/turf/open/indestructible/hotelwood,
/area/shuttle/blackmarket_chevvy)
"eu" = (
/obj/structure/table/wood,
/obj/item/gun/ballistic/bow,
/obj/item/gun/ballistic/bow{
	pixel_x = -6;
	pixel_y = -2
	},
/obj/item/storage/bag/quiver{
	pixel_y = -7;
	pixel_x = -7
	},
/turf/open/indestructible/hotelwood,
/area/shuttle/blackmarket_chevvy)
"jD" = (
/obj/structure/table/wood,
/obj/item/hatchet/wooden,
/obj/item/hatchet/wooden{
	pixel_x = 5;
	pixel_y = 4
	},
/obj/item/hatchet/wooden{
	pixel_y = 8;
	pixel_x = -3
	},
/turf/open/indestructible/hotelwood,
/area/shuttle/blackmarket_chevvy)
"ka" = (
/obj/structure/table/wood,
/obj/item/clothing/shoes/combat/expeditionary_corps{
	pixel_x = 4
	},
/obj/item/clothing/shoes/jackboots/ashwalker{
	pixel_x = 9;
	pixel_y = 9
	},
/obj/item/clothing/shoes/jackboots/ashwalker/legate{
	pixel_x = -8;
	pixel_y = -8
	},
/obj/item/clothing/shoes/cowboy/lizard/masterwork{
	pixel_x = -9;
	pixel_y = 9
	},
/turf/open/indestructible/hotelwood,
/area/shuttle/blackmarket_chevvy)
"nB" = (
/obj/structure/table/wood,
/obj/item/storage/box/papersack/meat,
/obj/item/storage/box/papersack/meat{
	pixel_x = 6;
	pixel_y = 5
	},
/obj/item/storage/box/papersack/meat{
	pixel_y = 9;
	pixel_x = -4
	},
/turf/open/indestructible/hotelwood,
/area/shuttle/blackmarket_chevvy)
"pI" = (
/obj/structure/table/wood,
/obj/item/melee/baseball_bat/ablative,
/obj/item/melee/cleric_mace{
	pixel_y = 10;
	pixel_x = 4
	},
/obj/item/melee/curator_whip{
	pixel_x = 3;
	pixel_y = -9
	},
/turf/open/indestructible/hotelwood,
/area/shuttle/blackmarket_chevvy)
"uW" = (
/obj/structure/table/wood,
/obj/item/melee/baton,
/obj/item/melee/baton{
	pixel_y = 6
	},
/obj/item/melee/chainofcommand/tailwhip/kitty{
	pixel_y = 9;
	pixel_x = -13
	},
/turf/open/indestructible/hotelwood,
/area/shuttle/blackmarket_chevvy)
"wE" = (
/obj/structure/table/wood,
/obj/item/grown/cotton/durathread{
	pixel_x = 6
	},
/obj/item/grown/cotton/durathread{
	pixel_y = -4
	},
/obj/item/grown/cotton/durathread{
	pixel_y = 7
	},
/obj/item/grown/cotton/durathread{
	pixel_x = -6;
	pixel_y = 2
	},
/turf/open/indestructible/hotelwood,
/area/shuttle/blackmarket_chevvy)
"yt" = (
/obj/structure/table/wood,
/obj/item/reagent_containers/food/drinks/bottle/lizardwine{
	pixel_y = 3
	},
/obj/item/reagent_containers/food/drinks/bottle/kahlua{
	pixel_x = 8
	},
/obj/item/reagent_containers/food/drinks/bottle/amaretto{
	pixel_y = 7;
	pixel_x = 18
	},
/obj/item/reagent_containers/food/drinks/bottle/applejack{
	pixel_x = -8;
	pixel_y = 3
	},
/turf/open/indestructible/hotelwood,
/area/shuttle/blackmarket_chevvy)
"zi" = (
/obj/structure/table/wood,
/obj/item/melee/tomahawk{
	pixel_y = 6
	},
/obj/item/melee/cleaving_saw,
/turf/open/indestructible/hotelwood,
/area/shuttle/blackmarket_chevvy)
"zH" = (
/obj/structure/table/wood,
/obj/item/clothing/head/helmet/gladiator,
/obj/item/clothing/head/helmet/gladiator,
/obj/item/clothing/head/helmet/gladiator,
/obj/item/clothing/head/helmet/elder_atmosian{
	pixel_x = 7;
	pixel_y = 6
	},
/obj/item/clothing/head/helmet/skull{
	pixel_y = 6;
	pixel_x = -8
	},
/turf/open/indestructible/hotelwood,
/area/shuttle/blackmarket_chevvy)
"Fu" = (
/obj/structure/table/wood,
/obj/item/knife/bowie,
/obj/item/knife/bowie{
	pixel_y = 2;
	pixel_x = 10
	},
/obj/item/reagent_containers/glass/bowl/mushroom_bowl{
	pixel_y = 12;
	pixel_x = -8
	},
/turf/open/indestructible/hotelwood,
/area/shuttle/blackmarket_chevvy)
"GO" = (
/obj/structure/table/wood/shuttle_bar,
/obj/structure/curtain/bounty,
/obj/structure/fans/tiny/invisible,
/turf/open/indestructible/hotelwood,
/area/shuttle/blackmarket_chevvy)
"Ov" = (
/turf/closed/indestructible/wood,
/area/shuttle/blackmarket_chevvy)
"OB" = (
/obj/structure/table/wood,
/obj/item/reagent_containers/food/drinks/bottle/vodka/badminka,
/obj/item/reagent_containers/food/drinks/bottle/hooch{
	pixel_x = -9;
	pixel_y = 8
	},
/obj/item/reagent_containers/food/drinks/bottle/moonshine{
	pixel_x = 10
	},
/turf/open/indestructible/hotelwood,
/area/shuttle/blackmarket_chevvy)
"OR" = (
/obj/structure/table/wood,
/obj/item/fishing_line/reinforced{
	pixel_x = 15
	},
/obj/item/fishing_hook/weighted{
	pixel_y = 8;
	pixel_x = 11
	},
/obj/item/fishing_hook/weighted{
	pixel_y = 11;
	pixel_x = 7
	},
/obj/item/fishing_hook/shiny{
	pixel_x = 5
	},
/obj/item/bait_can/worm/premium{
	pixel_y = 6;
	pixel_x = -5
	},
/obj/item/bait_can/worm/premium{
	pixel_y = 14;
	pixel_x = -5
	},
/turf/open/indestructible/hotelwood,
/area/shuttle/blackmarket_chevvy)
"PY" = (
/obj/structure/table/wood,
/obj/item/storage/belt/crusader,
/obj/item/storage/belt/crusader{
	pixel_y = 9;
	pixel_x = 3
	},
/obj/item/storage/backpack/satchel/crusader{
	pixel_y = 4
	},
/turf/open/indestructible/hotelwood,
/area/shuttle/blackmarket_chevvy)
"SY" = (
/obj/structure/table/wood,
/obj/item/reagent_containers/food/drinks/bottle/rum{
	pixel_y = 12
	},
/obj/item/reagent_containers/food/drinks/bottle/whiskey{
	pixel_y = 7;
	pixel_x = -8
	},
/obj/item/reagent_containers/food/drinks/bottle/trappist{
	pixel_x = 4
	},
/turf/open/indestructible/hotelwood,
/area/shuttle/blackmarket_chevvy)
"Tk" = (
/turf/open/indestructible/hotelwood,
/area/shuttle/blackmarket_chevvy)
"YP" = (
/turf/closed/indestructible/weeb,
/area/shuttle/blackmarket_chevvy)
"YX" = (
/obj/structure/table/wood,
/obj/item/seeds/lavaland/cactus{
	pixel_y = 4
	},
/obj/item/seeds/korta_nut/sweet{
	pixel_x = -7
	},
/obj/item/seeds/kronkus{
	pixel_y = 18;
	pixel_x = 10
	},
/turf/open/indestructible/hotelwood,
/area/shuttle/blackmarket_chevvy)
"ZC" = (
/obj/structure/table/wood,
/obj/item/papercutter,
/obj/item/seeds/tea/catnip{
	pixel_y = 10
	},
/obj/item/seeds/tea/astra{
	pixel_x = 5
	},
/turf/open/indestructible/hotelwood,
/area/shuttle/blackmarket_chevvy)
"ZW" = (
/obj/docking_port/mobile{
	dwidth = 5;
	height = 7;
	id = "blackmarket_chevvy";
	launch_status = 0;
	name = "Chevvy";
	port_direction = 8;
	preferred_direction = 4;
	width = 11
	},
/obj/structure/table/wood/shuttle_bar,
/obj/structure/curtain/bounty,
/obj/structure/fans/tiny/invisible,
/turf/open/indestructible/hotelwood,
/area/shuttle/blackmarket_chevvy)

(1,1,1) = {"
Ov
Ov
YP
YP
YP
Ov
Ov
"}
(2,1,1) = {"
Ov
ka
en
Tk
pI
zi
Ov
"}
(3,1,1) = {"
Ov
zH
Tk
Tk
Tk
uW
Ov
"}
(4,1,1) = {"
GO
Tk
Tk
OR
Tk
Tk
GO
"}
(5,1,1) = {"
GO
Tk
wE
cL
jD
Tk
GO
"}
(6,1,1) = {"
GO
Tk
Tk
Tk
Tk
Tk
ZW
"}
(7,1,1) = {"
GO
Tk
nB
ZC
YX
Tk
GO
"}
(8,1,1) = {"
GO
Tk
Tk
ad
Tk
Tk
GO
"}
(9,1,1) = {"
Ov
Fu
Tk
Tk
Tk
yt
Ov
"}
(10,1,1) = {"
Ov
eu
PY
Tk
OB
SY
Ov
"}
(11,1,1) = {"
Ov
Ov
YP
YP
YP
Ov
Ov
"}
