//MAP CONVERTED BY dmm2tgm.py THIS HEADER COMMENT PREVENTS RECONVERSION, DO NOT REMOVE
"bd" = (
/turf/closed/mineral/asteroid{
	initial_gas_mix = "o2=22;n2=82;TEMP=293.15";
	baseturfs = /turf/open/misc/asteroid
	},
/area/df_event/underground)
"dY" = (
/obj/structure/stairs/south,
/turf/open/misc/asteroid,
/area/df_event/underground)
"em" = (
/turf/open/openspace,
/area/df_event/underground)
"eI" = (
/turf/closed/mineral/ash_rock{
	baseturfs = /turf/open/misc/asteroid;
	initial_gas_mix = "o2=22;n2=82;TEMP=293.15"
	},
/area/df_event/underground)
"xO" = (
/obj/effect/landmark/latejoin,
/turf/open/misc/grass/planet,
/area/df_event)
"GG" = (
/turf/open/openspace,
/area/df_event)
"JH" = (
/turf/open/misc/grass/planet,
/area/df_event)
"RQ" = (
/turf/open/misc/asteroid,
/area/df_event/underground)

(1,1,1) = {"
bd
bd
bd
bd
bd
bd
bd
bd
bd
bd
bd
bd
bd
bd
bd
bd
bd
bd
bd
bd
bd
bd
bd
bd
bd
bd
bd
bd
bd
bd
bd
bd
bd
bd
bd
bd
bd
bd
bd
bd
bd
bd
bd
bd
bd
bd
bd
bd
bd
bd
bd
bd
"}
(2,1,1) = {"
bd
bd
bd
bd
bd
bd
bd
bd
bd
bd
bd
bd
bd
bd
bd
bd
bd
bd
bd
bd
bd
bd
bd
bd
bd
bd
bd
bd
bd
bd
bd
bd
bd
bd
bd
bd
bd
bd
bd
bd
bd
bd
bd
bd
bd
bd
bd
bd
bd
bd
bd
bd
"}
(3,1,1) = {"
bd
bd
bd
bd
bd
bd
bd
bd
bd
bd
bd
bd
bd
bd
bd
bd
bd
bd
bd
bd
bd
bd
bd
bd
bd
bd
bd
bd
bd
bd
bd
bd
bd
bd
bd
bd
bd
bd
bd
bd
bd
bd
bd
bd
bd
bd
bd
bd
bd
bd
bd
bd
"}
(4,1,1) = {"
bd
bd
bd
bd
bd
bd
bd
bd
bd
bd
bd
bd
bd
bd
bd
bd
bd
bd
bd
bd
bd
bd
bd
bd
bd
bd
bd
bd
bd
bd
bd
bd
bd
bd
bd
bd
bd
bd
bd
bd
bd
bd
bd
bd
bd
bd
bd
bd
bd
bd
bd
bd
"}
(5,1,1) = {"
bd
bd
bd
bd
bd
bd
bd
bd
bd
bd
bd
bd
bd
bd
bd
bd
bd
bd
bd
bd
bd
bd
bd
bd
bd
bd
bd
bd
bd
bd
bd
bd
bd
bd
bd
bd
bd
bd
bd
bd
bd
bd
bd
bd
bd
bd
bd
bd
bd
bd
bd
bd
"}
(6,1,1) = {"
bd
bd
bd
bd
bd
bd
bd
bd
bd
bd
bd
bd
bd
bd
bd
bd
bd
bd
bd
bd
bd
bd
bd
bd
bd
bd
bd
bd
bd
bd
bd
bd
bd
bd
bd
bd
bd
bd
bd
bd
bd
bd
bd
bd
bd
bd
bd
bd
bd
bd
bd
bd
"}
(7,1,1) = {"
bd
bd
bd
bd
bd
bd
bd
bd
bd
bd
bd
bd
bd
bd
bd
bd
bd
bd
bd
bd
bd
bd
bd
bd
bd
bd
bd
bd
bd
bd
bd
bd
bd
bd
bd
bd
bd
bd
bd
bd
bd
bd
bd
bd
bd
bd
bd
bd
bd
bd
bd
bd
"}
(8,1,1) = {"
bd
bd
bd
bd
bd
bd
bd
bd
bd
bd
bd
bd
bd
bd
bd
bd
bd
bd
bd
bd
bd
bd
bd
bd
bd
bd
bd
bd
bd
bd
bd
bd
bd
bd
bd
bd
bd
bd
bd
bd
bd
bd
bd
bd
bd
bd
bd
bd
bd
bd
bd
bd
"}
(9,1,1) = {"
bd
bd
bd
bd
bd
bd
bd
bd
bd
bd
bd
bd
bd
bd
bd
bd
bd
bd
bd
bd
bd
bd
bd
bd
bd
bd
bd
bd
bd
bd
bd
bd
bd
bd
bd
bd
bd
bd
bd
bd
bd
bd
bd
bd
bd
bd
bd
bd
bd
bd
bd
bd
"}
(10,1,1) = {"
bd
bd
bd
bd
bd
bd
bd
bd
bd
bd
bd
bd
bd
bd
bd
bd
bd
bd
bd
bd
bd
bd
bd
bd
bd
bd
bd
bd
bd
bd
bd
bd
bd
bd
bd
bd
bd
bd
bd
bd
bd
bd
bd
bd
bd
bd
bd
bd
bd
bd
bd
bd
"}
(11,1,1) = {"
bd
bd
bd
bd
bd
bd
bd
bd
bd
bd
bd
bd
bd
bd
bd
bd
bd
bd
bd
bd
bd
bd
bd
bd
bd
bd
bd
bd
bd
bd
bd
bd
bd
bd
bd
bd
bd
bd
bd
bd
bd
bd
bd
bd
bd
bd
bd
bd
bd
bd
bd
bd
"}
(12,1,1) = {"
bd
bd
bd
bd
bd
bd
bd
bd
bd
bd
bd
bd
bd
bd
bd
bd
bd
bd
bd
bd
bd
bd
bd
bd
bd
bd
bd
bd
bd
bd
bd
bd
bd
bd
bd
bd
bd
bd
bd
bd
bd
bd
bd
bd
bd
bd
bd
bd
bd
bd
bd
bd
"}
(13,1,1) = {"
bd
bd
bd
bd
bd
bd
bd
bd
bd
bd
bd
bd
bd
bd
bd
bd
bd
bd
bd
bd
bd
bd
bd
bd
bd
bd
bd
bd
bd
bd
bd
bd
bd
bd
bd
bd
bd
bd
bd
bd
bd
bd
bd
bd
bd
bd
bd
bd
bd
bd
bd
bd
"}
(14,1,1) = {"
bd
bd
bd
bd
bd
bd
bd
bd
bd
bd
bd
bd
bd
bd
bd
bd
bd
bd
bd
bd
bd
bd
bd
bd
bd
bd
bd
bd
bd
bd
bd
bd
bd
bd
bd
bd
bd
bd
bd
bd
bd
bd
bd
bd
bd
bd
bd
bd
bd
bd
bd
bd
"}
(15,1,1) = {"
bd
bd
bd
bd
bd
bd
bd
bd
bd
bd
bd
bd
bd
bd
bd
bd
bd
bd
bd
bd
bd
bd
RQ
RQ
RQ
RQ
RQ
RQ
RQ
RQ
bd
bd
bd
bd
bd
bd
bd
bd
bd
bd
bd
bd
bd
bd
bd
bd
bd
bd
bd
bd
bd
bd
"}
(16,1,1) = {"
bd
bd
bd
bd
bd
bd
bd
bd
bd
bd
bd
bd
bd
bd
bd
bd
bd
bd
bd
bd
RQ
RQ
RQ
RQ
RQ
RQ
RQ
RQ
RQ
RQ
RQ
RQ
bd
bd
bd
bd
bd
bd
bd
bd
bd
bd
bd
bd
bd
bd
bd
bd
bd
bd
bd
bd
"}
(17,1,1) = {"
bd
bd
bd
bd
bd
bd
bd
bd
bd
bd
bd
bd
bd
bd
bd
bd
bd
bd
bd
RQ
RQ
RQ
RQ
RQ
RQ
RQ
RQ
RQ
RQ
RQ
RQ
RQ
bd
bd
bd
bd
bd
bd
bd
bd
bd
bd
bd
bd
bd
bd
bd
bd
bd
bd
bd
bd
"}
(18,1,1) = {"
bd
bd
bd
bd
bd
bd
bd
bd
bd
bd
bd
bd
bd
bd
bd
bd
bd
bd
bd
RQ
RQ
RQ
RQ
RQ
RQ
RQ
RQ
RQ
RQ
RQ
RQ
RQ
RQ
bd
bd
bd
bd
bd
bd
bd
bd
bd
bd
bd
bd
bd
bd
bd
bd
bd
bd
bd
"}
(19,1,1) = {"
bd
bd
bd
bd
bd
bd
bd
bd
bd
bd
bd
bd
bd
bd
bd
bd
bd
bd
bd
RQ
RQ
RQ
RQ
RQ
RQ
RQ
RQ
RQ
RQ
RQ
RQ
RQ
RQ
bd
bd
bd
bd
bd
bd
bd
bd
bd
bd
bd
bd
bd
bd
bd
bd
bd
bd
bd
"}
(20,1,1) = {"
bd
bd
bd
bd
bd
bd
bd
bd
bd
bd
bd
bd
bd
bd
bd
bd
bd
bd
bd
RQ
RQ
RQ
RQ
RQ
RQ
RQ
RQ
RQ
RQ
RQ
RQ
RQ
RQ
RQ
bd
bd
bd
bd
bd
bd
bd
bd
bd
bd
bd
bd
bd
bd
bd
bd
bd
bd
"}
(21,1,1) = {"
bd
bd
bd
bd
bd
bd
bd
bd
bd
bd
bd
bd
bd
bd
bd
bd
bd
bd
RQ
RQ
RQ
RQ
RQ
RQ
RQ
RQ
RQ
RQ
RQ
RQ
RQ
RQ
RQ
RQ
bd
bd
bd
bd
bd
bd
bd
bd
bd
bd
bd
bd
bd
bd
bd
bd
bd
bd
"}
(22,1,1) = {"
bd
bd
bd
bd
bd
bd
bd
bd
bd
bd
bd
bd
bd
bd
bd
bd
bd
bd
RQ
RQ
RQ
RQ
RQ
RQ
RQ
RQ
RQ
RQ
RQ
RQ
RQ
RQ
RQ
RQ
bd
bd
bd
bd
bd
bd
bd
bd
bd
bd
bd
bd
bd
bd
bd
bd
bd
bd
"}
(23,1,1) = {"
bd
bd
bd
bd
bd
bd
bd
bd
bd
bd
bd
bd
bd
bd
bd
bd
bd
bd
RQ
RQ
RQ
RQ
RQ
RQ
RQ
RQ
RQ
RQ
RQ
RQ
RQ
RQ
RQ
RQ
bd
bd
bd
bd
bd
bd
bd
bd
bd
bd
bd
bd
bd
bd
bd
bd
bd
bd
"}
(24,1,1) = {"
bd
bd
bd
bd
bd
bd
bd
bd
bd
bd
bd
bd
bd
bd
bd
bd
bd
bd
RQ
RQ
RQ
RQ
RQ
RQ
RQ
RQ
RQ
RQ
RQ
RQ
RQ
RQ
RQ
RQ
bd
bd
bd
bd
bd
bd
bd
bd
bd
bd
bd
bd
bd
bd
bd
bd
bd
bd
"}
(25,1,1) = {"
bd
bd
bd
bd
bd
bd
bd
bd
bd
bd
bd
bd
bd
bd
bd
bd
bd
bd
RQ
RQ
RQ
RQ
RQ
RQ
RQ
RQ
RQ
RQ
RQ
RQ
RQ
RQ
RQ
RQ
RQ
bd
bd
bd
bd
bd
bd
bd
bd
bd
bd
bd
bd
bd
bd
bd
bd
bd
"}
(26,1,1) = {"
bd
bd
bd
bd
bd
bd
bd
bd
bd
bd
bd
bd
bd
bd
bd
bd
bd
bd
RQ
RQ
RQ
RQ
RQ
RQ
RQ
RQ
RQ
RQ
RQ
RQ
RQ
RQ
RQ
RQ
RQ
bd
bd
bd
bd
bd
bd
bd
bd
bd
bd
bd
bd
bd
bd
bd
bd
bd
"}
(27,1,1) = {"
bd
bd
bd
bd
bd
bd
bd
bd
bd
bd
bd
bd
bd
bd
bd
bd
bd
bd
RQ
RQ
RQ
RQ
RQ
RQ
RQ
RQ
RQ
RQ
RQ
RQ
RQ
dY
RQ
RQ
RQ
bd
bd
bd
bd
bd
bd
bd
bd
bd
bd
bd
bd
bd
bd
bd
bd
bd
"}
(28,1,1) = {"
bd
bd
bd
bd
bd
bd
bd
bd
bd
bd
bd
bd
bd
bd
bd
bd
bd
bd
bd
RQ
RQ
RQ
RQ
RQ
RQ
RQ
RQ
RQ
RQ
RQ
RQ
RQ
RQ
RQ
RQ
bd
bd
bd
bd
bd
bd
bd
bd
bd
bd
bd
bd
bd
bd
bd
bd
bd
"}
(29,1,1) = {"
bd
bd
bd
bd
bd
bd
bd
bd
bd
bd
bd
bd
bd
bd
bd
bd
bd
bd
bd
RQ
RQ
RQ
RQ
RQ
RQ
RQ
RQ
RQ
RQ
RQ
RQ
RQ
RQ
RQ
RQ
bd
bd
bd
bd
bd
bd
bd
bd
bd
bd
bd
bd
bd
bd
bd
bd
bd
"}
(30,1,1) = {"
bd
bd
bd
bd
bd
bd
bd
bd
bd
bd
bd
bd
bd
bd
bd
bd
bd
bd
bd
bd
RQ
RQ
RQ
RQ
RQ
RQ
RQ
RQ
RQ
RQ
RQ
RQ
RQ
RQ
RQ
bd
bd
bd
bd
bd
bd
bd
bd
bd
bd
bd
bd
bd
bd
bd
bd
bd
"}
(31,1,1) = {"
bd
bd
bd
bd
bd
bd
bd
bd
bd
bd
bd
bd
bd
bd
bd
bd
bd
bd
bd
bd
RQ
RQ
RQ
RQ
RQ
RQ
RQ
RQ
RQ
RQ
RQ
RQ
RQ
RQ
RQ
bd
bd
bd
bd
bd
bd
bd
bd
bd
bd
bd
bd
bd
bd
bd
bd
bd
"}
(32,1,1) = {"
bd
bd
bd
bd
bd
bd
bd
bd
bd
bd
bd
bd
bd
bd
bd
bd
bd
bd
bd
bd
bd
RQ
RQ
RQ
RQ
RQ
RQ
RQ
RQ
RQ
RQ
RQ
RQ
RQ
RQ
bd
bd
bd
bd
bd
bd
bd
bd
bd
bd
bd
bd
bd
bd
bd
bd
bd
"}
(33,1,1) = {"
bd
bd
bd
bd
bd
bd
bd
bd
bd
bd
bd
bd
bd
bd
bd
bd
bd
bd
bd
bd
bd
bd
RQ
RQ
RQ
RQ
RQ
RQ
RQ
RQ
RQ
RQ
RQ
RQ
bd
bd
bd
bd
bd
bd
bd
bd
bd
bd
bd
bd
bd
bd
bd
bd
bd
bd
"}
(34,1,1) = {"
bd
bd
bd
bd
bd
bd
bd
bd
bd
bd
bd
bd
bd
bd
bd
bd
bd
bd
bd
bd
bd
bd
RQ
RQ
RQ
RQ
RQ
RQ
RQ
RQ
RQ
RQ
RQ
RQ
bd
bd
bd
bd
bd
bd
bd
bd
bd
bd
bd
bd
bd
bd
bd
bd
bd
bd
"}
(35,1,1) = {"
bd
bd
bd
bd
bd
bd
bd
bd
bd
bd
bd
bd
bd
bd
bd
bd
bd
bd
bd
bd
bd
bd
bd
bd
RQ
RQ
RQ
RQ
RQ
RQ
RQ
RQ
RQ
bd
bd
bd
bd
bd
bd
bd
bd
bd
bd
bd
bd
bd
bd
bd
bd
bd
bd
bd
"}
(36,1,1) = {"
bd
bd
bd
bd
bd
bd
bd
bd
bd
bd
bd
bd
bd
bd
bd
bd
bd
bd
bd
bd
bd
bd
bd
bd
bd
RQ
RQ
RQ
RQ
RQ
RQ
RQ
bd
bd
bd
bd
bd
bd
bd
bd
bd
bd
bd
bd
bd
bd
bd
bd
bd
bd
bd
bd
"}
(37,1,1) = {"
bd
bd
bd
bd
bd
bd
bd
bd
bd
bd
bd
bd
bd
bd
bd
bd
bd
bd
bd
bd
bd
bd
bd
bd
bd
bd
bd
bd
bd
bd
bd
bd
bd
bd
bd
bd
bd
bd
bd
bd
bd
bd
bd
bd
bd
bd
bd
bd
bd
bd
bd
bd
"}
(38,1,1) = {"
bd
bd
bd
bd
bd
bd
bd
bd
bd
bd
bd
bd
bd
bd
bd
bd
bd
bd
bd
bd
bd
bd
bd
bd
bd
bd
bd
bd
bd
bd
bd
bd
bd
bd
bd
bd
bd
bd
bd
bd
bd
bd
bd
bd
bd
bd
bd
bd
bd
bd
bd
bd
"}
(39,1,1) = {"
bd
bd
bd
bd
bd
bd
bd
bd
bd
bd
bd
bd
bd
bd
bd
bd
bd
bd
bd
bd
bd
bd
bd
bd
bd
bd
bd
bd
bd
bd
bd
bd
bd
bd
bd
bd
bd
bd
bd
bd
bd
bd
bd
bd
bd
bd
bd
bd
bd
bd
bd
bd
"}
(40,1,1) = {"
bd
bd
bd
bd
bd
bd
bd
bd
bd
bd
bd
bd
bd
bd
bd
bd
bd
bd
bd
bd
bd
bd
bd
bd
bd
bd
bd
bd
bd
bd
bd
bd
bd
bd
bd
bd
bd
bd
bd
bd
bd
bd
bd
bd
bd
bd
bd
bd
bd
bd
bd
bd
"}
(41,1,1) = {"
bd
bd
bd
bd
bd
bd
bd
bd
bd
bd
bd
bd
bd
bd
bd
bd
bd
bd
bd
bd
bd
bd
bd
bd
bd
bd
bd
bd
bd
bd
bd
bd
bd
bd
bd
bd
bd
bd
bd
bd
bd
bd
bd
bd
bd
bd
bd
bd
bd
bd
bd
bd
"}
(42,1,1) = {"
bd
bd
bd
bd
bd
bd
bd
bd
bd
bd
bd
bd
bd
bd
bd
bd
bd
bd
bd
bd
bd
bd
bd
bd
bd
bd
bd
bd
bd
bd
bd
bd
bd
bd
bd
bd
bd
bd
bd
bd
bd
bd
bd
bd
bd
bd
bd
bd
bd
bd
bd
bd
"}
(43,1,1) = {"
bd
bd
bd
bd
bd
bd
bd
bd
bd
bd
bd
bd
bd
bd
bd
bd
bd
bd
bd
bd
bd
bd
bd
bd
bd
bd
bd
bd
bd
bd
bd
bd
bd
bd
bd
bd
bd
bd
bd
bd
bd
bd
bd
bd
bd
bd
bd
bd
bd
bd
bd
bd
"}
(44,1,1) = {"
bd
bd
bd
bd
bd
bd
bd
bd
bd
bd
bd
bd
bd
bd
bd
bd
bd
bd
bd
bd
bd
bd
bd
bd
bd
bd
bd
bd
bd
bd
bd
bd
bd
bd
bd
bd
bd
bd
bd
bd
bd
bd
bd
bd
bd
bd
bd
bd
bd
bd
bd
bd
"}
(45,1,1) = {"
bd
bd
bd
bd
bd
bd
bd
bd
bd
bd
bd
bd
bd
bd
bd
bd
bd
bd
bd
bd
bd
bd
bd
bd
bd
bd
bd
bd
bd
bd
bd
bd
bd
bd
bd
bd
bd
bd
bd
bd
bd
bd
bd
bd
bd
bd
bd
bd
bd
bd
bd
bd
"}
(46,1,1) = {"
bd
bd
bd
bd
bd
bd
bd
bd
bd
bd
bd
bd
bd
bd
bd
bd
bd
bd
bd
bd
bd
bd
bd
bd
bd
bd
bd
bd
bd
bd
bd
bd
bd
bd
bd
bd
bd
bd
bd
bd
bd
bd
bd
bd
bd
bd
bd
bd
bd
bd
bd
bd
"}
(47,1,1) = {"
bd
bd
bd
bd
bd
bd
bd
bd
bd
bd
bd
bd
bd
bd
bd
bd
bd
bd
bd
bd
bd
bd
bd
bd
bd
bd
bd
bd
bd
bd
bd
bd
bd
bd
bd
bd
bd
bd
bd
bd
bd
bd
bd
bd
bd
bd
bd
bd
bd
bd
bd
bd
"}
(48,1,1) = {"
bd
bd
bd
bd
bd
bd
bd
bd
bd
bd
bd
bd
bd
bd
bd
bd
bd
bd
bd
bd
bd
bd
bd
bd
bd
bd
bd
bd
bd
bd
bd
bd
bd
bd
bd
bd
bd
bd
bd
bd
bd
bd
bd
bd
bd
bd
bd
bd
bd
bd
bd
bd
"}
(49,1,1) = {"
bd
bd
bd
bd
bd
bd
bd
bd
bd
bd
bd
bd
bd
bd
bd
bd
bd
bd
bd
bd
bd
bd
bd
bd
bd
bd
bd
bd
bd
bd
bd
bd
bd
bd
bd
bd
bd
bd
bd
bd
bd
bd
bd
bd
bd
bd
bd
bd
bd
bd
bd
bd
"}
(50,1,1) = {"
bd
bd
bd
bd
bd
bd
bd
bd
bd
bd
bd
bd
bd
bd
bd
bd
bd
bd
bd
bd
bd
bd
bd
bd
bd
bd
bd
bd
bd
bd
bd
bd
bd
bd
bd
bd
bd
bd
bd
bd
bd
bd
bd
bd
bd
bd
bd
bd
bd
bd
bd
bd
"}
(51,1,1) = {"
bd
bd
bd
bd
bd
bd
bd
bd
bd
bd
bd
bd
bd
bd
bd
bd
bd
bd
bd
bd
bd
bd
bd
bd
bd
bd
bd
bd
bd
bd
bd
bd
bd
bd
bd
bd
bd
bd
bd
bd
bd
bd
bd
bd
bd
bd
bd
bd
bd
bd
bd
bd
"}
(52,1,1) = {"
bd
bd
bd
bd
bd
bd
bd
bd
bd
bd
bd
bd
bd
bd
bd
bd
bd
bd
bd
bd
bd
bd
bd
bd
bd
bd
bd
bd
bd
bd
bd
bd
bd
bd
bd
bd
bd
bd
bd
bd
bd
bd
bd
bd
bd
bd
bd
bd
bd
bd
bd
bd
"}

(1,1,2) = {"
eI
eI
eI
eI
eI
eI
eI
eI
eI
eI
eI
eI
eI
eI
eI
eI
eI
eI
eI
eI
eI
eI
eI
eI
eI
eI
eI
eI
eI
eI
eI
eI
eI
eI
eI
eI
eI
eI
eI
eI
eI
eI
eI
eI
eI
eI
eI
eI
eI
eI
eI
eI
"}
(2,1,2) = {"
eI
eI
eI
eI
eI
eI
eI
eI
eI
eI
eI
eI
eI
eI
eI
eI
eI
eI
eI
eI
eI
eI
eI
eI
eI
eI
eI
eI
eI
eI
eI
eI
eI
eI
eI
eI
eI
eI
eI
eI
eI
eI
eI
eI
eI
eI
eI
eI
eI
eI
eI
eI
"}
(3,1,2) = {"
eI
eI
eI
eI
eI
eI
eI
eI
eI
eI
eI
eI
eI
eI
eI
eI
eI
eI
eI
eI
eI
eI
eI
eI
eI
eI
eI
eI
eI
eI
eI
eI
eI
eI
eI
eI
eI
eI
eI
eI
eI
eI
eI
eI
eI
eI
eI
eI
eI
eI
eI
eI
"}
(4,1,2) = {"
eI
eI
eI
eI
eI
eI
eI
eI
eI
eI
eI
eI
eI
eI
eI
eI
eI
eI
eI
eI
eI
eI
eI
eI
eI
eI
eI
eI
eI
eI
eI
eI
eI
eI
eI
eI
eI
eI
eI
eI
eI
eI
eI
eI
eI
eI
eI
eI
eI
eI
eI
eI
"}
(5,1,2) = {"
eI
eI
eI
eI
eI
eI
eI
eI
eI
eI
eI
eI
eI
eI
eI
eI
eI
eI
eI
eI
eI
eI
eI
eI
eI
eI
eI
eI
eI
eI
eI
eI
eI
eI
eI
eI
eI
eI
eI
eI
eI
eI
eI
eI
eI
eI
eI
eI
eI
eI
eI
eI
"}
(6,1,2) = {"
eI
eI
eI
eI
eI
eI
eI
eI
eI
eI
eI
eI
eI
eI
eI
eI
eI
eI
eI
eI
eI
eI
eI
eI
eI
eI
eI
eI
eI
eI
eI
eI
eI
eI
eI
eI
eI
eI
eI
eI
eI
eI
eI
eI
eI
eI
eI
eI
eI
eI
eI
eI
"}
(7,1,2) = {"
eI
eI
eI
eI
eI
eI
eI
eI
eI
eI
eI
eI
eI
eI
eI
eI
eI
eI
eI
eI
eI
eI
eI
eI
eI
eI
eI
eI
eI
eI
eI
eI
eI
eI
eI
eI
eI
eI
eI
eI
eI
eI
eI
eI
eI
eI
eI
eI
eI
eI
eI
eI
"}
(8,1,2) = {"
eI
eI
eI
eI
eI
eI
eI
eI
eI
eI
eI
eI
eI
eI
eI
eI
eI
eI
eI
eI
eI
eI
eI
eI
eI
eI
eI
eI
eI
eI
eI
eI
eI
eI
eI
eI
eI
eI
eI
eI
eI
eI
eI
eI
eI
eI
eI
eI
eI
eI
eI
eI
"}
(9,1,2) = {"
eI
eI
eI
eI
eI
eI
eI
eI
eI
eI
eI
eI
eI
eI
eI
eI
eI
eI
eI
eI
eI
eI
eI
eI
eI
eI
eI
eI
eI
eI
eI
eI
eI
eI
eI
eI
eI
eI
eI
eI
eI
eI
eI
eI
eI
eI
eI
eI
eI
eI
eI
eI
"}
(10,1,2) = {"
eI
eI
eI
eI
eI
eI
eI
eI
eI
eI
eI
eI
eI
eI
eI
eI
eI
eI
eI
eI
eI
eI
eI
eI
eI
eI
eI
eI
eI
eI
eI
eI
eI
eI
eI
eI
eI
eI
eI
eI
eI
eI
eI
eI
eI
eI
eI
eI
eI
eI
eI
eI
"}
(11,1,2) = {"
eI
eI
eI
eI
eI
eI
eI
eI
eI
eI
eI
eI
eI
eI
eI
eI
eI
eI
eI
eI
eI
eI
eI
eI
eI
eI
eI
eI
eI
eI
eI
eI
eI
eI
eI
eI
eI
eI
eI
eI
eI
eI
eI
eI
eI
eI
eI
eI
eI
eI
eI
eI
"}
(12,1,2) = {"
eI
eI
eI
eI
eI
eI
eI
eI
eI
eI
eI
eI
eI
eI
eI
eI
eI
eI
eI
eI
eI
eI
eI
eI
eI
eI
eI
eI
eI
eI
eI
eI
eI
eI
eI
eI
eI
eI
eI
eI
eI
eI
eI
eI
eI
eI
eI
eI
eI
eI
eI
eI
"}
(13,1,2) = {"
eI
eI
eI
eI
eI
eI
eI
eI
eI
eI
eI
eI
eI
eI
eI
eI
eI
eI
eI
eI
eI
eI
eI
eI
eI
eI
eI
eI
eI
eI
eI
eI
eI
eI
eI
eI
eI
eI
eI
eI
eI
eI
eI
eI
eI
eI
eI
eI
eI
eI
eI
eI
"}
(14,1,2) = {"
eI
eI
eI
eI
eI
eI
eI
eI
eI
eI
eI
eI
eI
eI
eI
eI
eI
eI
eI
eI
eI
eI
eI
RQ
RQ
RQ
RQ
RQ
RQ
RQ
RQ
RQ
eI
eI
eI
eI
eI
eI
eI
eI
eI
eI
eI
eI
eI
eI
eI
eI
eI
eI
eI
eI
"}
(15,1,2) = {"
eI
eI
eI
eI
eI
eI
eI
eI
eI
eI
eI
eI
eI
eI
eI
eI
eI
eI
eI
eI
RQ
RQ
RQ
RQ
RQ
RQ
RQ
RQ
RQ
RQ
RQ
RQ
RQ
eI
eI
eI
eI
eI
eI
eI
eI
eI
eI
eI
eI
eI
eI
eI
eI
eI
eI
eI
"}
(16,1,2) = {"
eI
eI
eI
eI
eI
eI
eI
eI
eI
eI
eI
eI
eI
eI
eI
eI
eI
eI
eI
RQ
RQ
RQ
RQ
RQ
RQ
RQ
RQ
RQ
RQ
RQ
RQ
RQ
RQ
RQ
eI
eI
eI
eI
eI
eI
eI
eI
eI
eI
eI
eI
eI
eI
eI
eI
eI
eI
"}
(17,1,2) = {"
eI
eI
eI
eI
eI
eI
eI
eI
eI
eI
eI
eI
eI
eI
eI
eI
eI
eI
eI
RQ
RQ
RQ
RQ
RQ
RQ
RQ
RQ
RQ
RQ
RQ
RQ
RQ
RQ
RQ
eI
eI
eI
eI
eI
eI
eI
eI
eI
eI
eI
eI
eI
eI
eI
eI
eI
eI
"}
(18,1,2) = {"
eI
eI
eI
eI
eI
eI
eI
eI
eI
eI
eI
eI
eI
eI
eI
eI
eI
eI
RQ
RQ
RQ
RQ
RQ
RQ
RQ
RQ
RQ
RQ
RQ
RQ
RQ
RQ
RQ
RQ
RQ
eI
eI
eI
eI
eI
eI
eI
eI
eI
eI
eI
eI
eI
eI
eI
eI
eI
"}
(19,1,2) = {"
eI
eI
eI
eI
eI
eI
eI
eI
eI
eI
eI
eI
eI
eI
eI
eI
eI
eI
RQ
RQ
RQ
RQ
RQ
RQ
RQ
RQ
RQ
RQ
RQ
RQ
RQ
RQ
RQ
RQ
RQ
RQ
eI
eI
eI
eI
eI
eI
eI
eI
eI
eI
eI
eI
eI
eI
eI
eI
"}
(20,1,2) = {"
eI
eI
eI
eI
eI
eI
eI
eI
eI
eI
eI
eI
eI
eI
eI
eI
eI
eI
RQ
RQ
RQ
RQ
RQ
em
em
em
em
em
RQ
RQ
RQ
RQ
RQ
RQ
RQ
RQ
eI
eI
eI
eI
eI
eI
eI
eI
eI
eI
eI
eI
eI
eI
eI
eI
"}
(21,1,2) = {"
eI
eI
eI
eI
eI
eI
eI
eI
eI
eI
eI
eI
eI
eI
eI
eI
eI
RQ
RQ
RQ
RQ
RQ
em
em
em
em
em
em
em
RQ
RQ
RQ
RQ
RQ
RQ
RQ
eI
eI
eI
eI
eI
eI
eI
eI
eI
eI
eI
eI
eI
eI
eI
eI
"}
(22,1,2) = {"
eI
eI
eI
eI
eI
eI
eI
eI
eI
eI
eI
eI
eI
eI
eI
eI
eI
RQ
RQ
RQ
RQ
RQ
em
em
em
em
em
em
em
em
RQ
RQ
RQ
RQ
RQ
RQ
RQ
eI
eI
eI
eI
eI
eI
eI
eI
eI
eI
eI
eI
eI
eI
eI
"}
(23,1,2) = {"
eI
eI
eI
eI
eI
eI
eI
eI
eI
eI
eI
eI
eI
eI
eI
eI
eI
RQ
RQ
RQ
RQ
em
em
em
em
em
em
em
em
em
em
RQ
RQ
RQ
RQ
RQ
RQ
eI
eI
eI
eI
eI
eI
eI
eI
eI
eI
eI
eI
eI
eI
eI
"}
(24,1,2) = {"
eI
eI
eI
eI
eI
eI
eI
eI
eI
eI
eI
eI
eI
eI
eI
eI
RQ
RQ
RQ
RQ
RQ
em
em
em
em
em
em
em
em
em
em
RQ
RQ
RQ
RQ
RQ
RQ
eI
eI
eI
eI
eI
eI
eI
eI
eI
eI
eI
eI
eI
eI
eI
"}
(25,1,2) = {"
eI
eI
eI
eI
eI
eI
eI
eI
eI
eI
eI
eI
eI
eI
eI
eI
RQ
RQ
RQ
RQ
RQ
em
em
em
em
em
em
em
em
em
em
RQ
RQ
RQ
RQ
RQ
RQ
eI
eI
eI
eI
eI
eI
eI
eI
eI
eI
eI
eI
eI
eI
eI
"}
(26,1,2) = {"
eI
eI
eI
eI
eI
eI
eI
eI
eI
eI
eI
eI
eI
eI
eI
eI
RQ
RQ
RQ
RQ
RQ
em
em
em
em
em
em
em
em
em
em
em
RQ
RQ
RQ
RQ
RQ
eI
eI
eI
eI
eI
eI
eI
eI
eI
eI
eI
eI
eI
eI
eI
"}
(27,1,2) = {"
eI
eI
eI
eI
eI
eI
eI
eI
eI
eI
eI
eI
eI
eI
eI
eI
RQ
RQ
RQ
RQ
RQ
em
em
em
em
em
em
em
em
em
em
em
dY
RQ
RQ
RQ
RQ
eI
eI
eI
eI
eI
eI
eI
eI
eI
eI
eI
eI
eI
eI
eI
"}
(28,1,2) = {"
eI
eI
eI
eI
eI
eI
eI
eI
eI
eI
eI
eI
eI
eI
eI
eI
RQ
RQ
RQ
RQ
RQ
RQ
em
em
em
em
em
em
em
em
em
em
RQ
RQ
RQ
RQ
RQ
eI
eI
eI
eI
eI
eI
eI
eI
eI
eI
eI
eI
eI
eI
eI
"}
(29,1,2) = {"
eI
eI
eI
eI
eI
eI
eI
eI
eI
eI
eI
eI
eI
eI
eI
eI
RQ
RQ
RQ
RQ
RQ
RQ
em
em
em
em
em
em
em
em
em
RQ
RQ
RQ
RQ
RQ
RQ
eI
eI
eI
eI
eI
eI
eI
eI
eI
eI
eI
eI
eI
eI
eI
"}
(30,1,2) = {"
eI
eI
eI
eI
eI
eI
eI
eI
eI
eI
eI
eI
eI
eI
eI
eI
eI
RQ
RQ
RQ
RQ
RQ
RQ
em
em
em
em
em
em
em
em
RQ
RQ
RQ
RQ
RQ
RQ
eI
eI
eI
eI
eI
eI
eI
eI
eI
eI
eI
eI
eI
eI
eI
"}
(31,1,2) = {"
eI
eI
eI
eI
eI
eI
eI
eI
eI
eI
eI
eI
eI
eI
eI
eI
eI
RQ
RQ
RQ
RQ
RQ
RQ
em
em
em
em
em
em
em
RQ
RQ
RQ
RQ
RQ
RQ
RQ
eI
eI
eI
eI
eI
eI
eI
eI
eI
eI
eI
eI
eI
eI
eI
"}
(32,1,2) = {"
eI
eI
eI
eI
eI
eI
eI
eI
eI
eI
eI
eI
eI
eI
eI
eI
eI
RQ
RQ
RQ
RQ
RQ
RQ
RQ
RQ
em
em
em
em
RQ
RQ
RQ
RQ
RQ
RQ
RQ
RQ
eI
eI
eI
eI
eI
eI
eI
eI
eI
eI
eI
eI
eI
eI
eI
"}
(33,1,2) = {"
eI
eI
eI
eI
eI
eI
eI
eI
eI
eI
eI
eI
eI
eI
eI
eI
eI
eI
RQ
RQ
RQ
RQ
RQ
RQ
RQ
RQ
RQ
RQ
RQ
RQ
RQ
RQ
RQ
RQ
RQ
RQ
RQ
eI
eI
eI
eI
eI
eI
eI
eI
eI
eI
eI
eI
eI
eI
eI
"}
(34,1,2) = {"
eI
eI
eI
eI
eI
eI
eI
eI
eI
eI
eI
eI
eI
eI
eI
eI
eI
eI
RQ
RQ
RQ
RQ
RQ
RQ
RQ
RQ
RQ
RQ
RQ
RQ
RQ
RQ
RQ
RQ
RQ
RQ
eI
eI
eI
eI
eI
eI
eI
eI
eI
eI
eI
eI
eI
eI
eI
eI
"}
(35,1,2) = {"
eI
eI
eI
eI
eI
eI
eI
eI
eI
eI
eI
eI
eI
eI
eI
eI
eI
eI
eI
RQ
RQ
RQ
RQ
RQ
RQ
RQ
RQ
RQ
RQ
RQ
RQ
RQ
RQ
RQ
RQ
RQ
eI
eI
eI
eI
eI
eI
eI
eI
eI
eI
eI
eI
eI
eI
eI
eI
"}
(36,1,2) = {"
eI
eI
eI
eI
eI
eI
eI
eI
eI
eI
eI
eI
eI
eI
eI
eI
eI
eI
eI
eI
RQ
RQ
RQ
RQ
RQ
RQ
RQ
RQ
RQ
RQ
RQ
RQ
RQ
RQ
RQ
RQ
eI
eI
eI
eI
eI
eI
eI
eI
eI
eI
eI
eI
eI
eI
eI
eI
"}
(37,1,2) = {"
eI
eI
eI
eI
eI
eI
eI
eI
eI
eI
eI
eI
eI
eI
eI
eI
eI
eI
eI
eI
eI
eI
RQ
RQ
RQ
RQ
RQ
RQ
RQ
RQ
RQ
RQ
RQ
RQ
RQ
eI
eI
eI
eI
eI
eI
eI
eI
eI
eI
eI
eI
eI
eI
eI
eI
eI
"}
(38,1,2) = {"
eI
eI
eI
eI
eI
eI
eI
eI
eI
eI
eI
eI
eI
eI
eI
eI
eI
eI
eI
eI
eI
eI
eI
eI
eI
RQ
RQ
RQ
RQ
RQ
RQ
RQ
RQ
eI
eI
eI
eI
eI
eI
eI
eI
eI
eI
eI
eI
eI
eI
eI
eI
eI
eI
eI
"}
(39,1,2) = {"
eI
eI
eI
eI
eI
eI
eI
eI
eI
eI
eI
eI
eI
eI
eI
eI
eI
eI
eI
eI
eI
eI
eI
eI
eI
eI
eI
eI
eI
eI
eI
eI
eI
eI
eI
eI
eI
eI
eI
eI
eI
eI
eI
eI
eI
eI
eI
eI
eI
eI
eI
eI
"}
(40,1,2) = {"
eI
eI
eI
eI
eI
eI
eI
eI
eI
eI
eI
eI
eI
eI
eI
eI
eI
eI
eI
eI
eI
eI
eI
eI
eI
eI
eI
eI
eI
eI
eI
eI
eI
eI
eI
eI
eI
eI
eI
eI
eI
eI
eI
eI
eI
eI
eI
eI
eI
eI
eI
eI
"}
(41,1,2) = {"
eI
eI
eI
eI
eI
eI
eI
eI
eI
eI
eI
eI
eI
eI
eI
eI
eI
eI
eI
eI
eI
eI
eI
eI
eI
eI
eI
eI
eI
eI
eI
eI
eI
eI
eI
eI
eI
eI
eI
eI
eI
eI
eI
eI
eI
eI
eI
eI
eI
eI
eI
eI
"}
(42,1,2) = {"
eI
eI
eI
eI
eI
eI
eI
eI
eI
eI
eI
eI
eI
eI
eI
eI
eI
eI
eI
eI
eI
eI
eI
eI
eI
eI
eI
eI
eI
eI
eI
eI
eI
eI
eI
eI
eI
eI
eI
eI
eI
eI
eI
eI
eI
eI
eI
eI
eI
eI
eI
eI
"}
(43,1,2) = {"
eI
eI
eI
eI
eI
eI
eI
eI
eI
eI
eI
eI
eI
eI
eI
eI
eI
eI
eI
eI
eI
eI
eI
eI
eI
eI
eI
eI
eI
eI
eI
eI
eI
eI
eI
eI
eI
eI
eI
eI
eI
eI
eI
eI
eI
eI
eI
eI
eI
eI
eI
eI
"}
(44,1,2) = {"
eI
eI
eI
eI
eI
eI
eI
eI
eI
eI
eI
eI
eI
eI
eI
eI
eI
eI
eI
eI
eI
eI
eI
eI
eI
eI
eI
eI
eI
eI
eI
eI
eI
eI
eI
eI
eI
eI
eI
eI
eI
eI
eI
eI
eI
eI
eI
eI
eI
eI
eI
eI
"}
(45,1,2) = {"
eI
eI
eI
eI
eI
eI
eI
eI
eI
eI
eI
eI
eI
eI
eI
eI
eI
eI
eI
eI
eI
eI
eI
eI
eI
eI
eI
eI
eI
eI
eI
eI
eI
eI
eI
eI
eI
eI
eI
eI
eI
eI
eI
eI
eI
eI
eI
eI
eI
eI
eI
eI
"}
(46,1,2) = {"
eI
eI
eI
eI
eI
eI
eI
eI
eI
eI
eI
eI
eI
eI
eI
eI
eI
eI
eI
eI
eI
eI
eI
eI
eI
eI
eI
eI
eI
eI
eI
eI
eI
eI
eI
eI
eI
eI
eI
eI
eI
eI
eI
eI
eI
eI
eI
eI
eI
eI
eI
eI
"}
(47,1,2) = {"
eI
eI
eI
eI
eI
eI
eI
eI
eI
eI
eI
eI
eI
eI
eI
eI
eI
eI
eI
eI
eI
eI
eI
eI
eI
eI
eI
eI
eI
eI
eI
eI
eI
eI
eI
eI
eI
eI
eI
eI
eI
eI
eI
eI
eI
eI
eI
eI
eI
eI
eI
eI
"}
(48,1,2) = {"
eI
eI
eI
eI
eI
eI
eI
eI
eI
eI
eI
eI
eI
eI
eI
eI
eI
eI
eI
eI
eI
eI
eI
eI
eI
eI
eI
eI
eI
eI
eI
eI
eI
eI
eI
eI
eI
eI
eI
eI
eI
eI
eI
eI
eI
eI
eI
eI
eI
eI
eI
eI
"}
(49,1,2) = {"
eI
eI
eI
eI
eI
eI
eI
eI
eI
eI
eI
eI
eI
eI
eI
eI
eI
eI
eI
eI
eI
eI
eI
eI
eI
eI
eI
eI
eI
eI
eI
eI
eI
eI
eI
eI
eI
eI
eI
eI
eI
eI
eI
eI
eI
eI
eI
eI
eI
eI
eI
eI
"}
(50,1,2) = {"
eI
eI
eI
eI
eI
eI
eI
eI
eI
eI
eI
eI
eI
eI
eI
eI
eI
eI
eI
eI
eI
eI
eI
eI
eI
eI
eI
eI
eI
eI
eI
eI
eI
eI
eI
eI
eI
eI
eI
eI
eI
eI
eI
eI
eI
eI
eI
eI
eI
eI
eI
eI
"}
(51,1,2) = {"
eI
eI
eI
eI
eI
eI
eI
eI
eI
eI
eI
eI
eI
eI
eI
eI
eI
eI
eI
eI
eI
eI
eI
eI
eI
eI
eI
eI
eI
eI
eI
eI
eI
eI
eI
eI
eI
eI
eI
eI
eI
eI
eI
eI
eI
eI
eI
eI
eI
eI
eI
eI
"}
(52,1,2) = {"
eI
eI
eI
eI
eI
eI
eI
eI
eI
eI
eI
eI
eI
eI
eI
eI
eI
eI
eI
eI
eI
eI
eI
eI
eI
eI
eI
eI
eI
eI
eI
eI
eI
eI
eI
eI
eI
eI
eI
eI
eI
eI
eI
eI
eI
eI
eI
eI
eI
eI
eI
eI
"}

(1,1,3) = {"
JH
JH
JH
JH
JH
JH
JH
JH
JH
JH
JH
JH
JH
JH
JH
JH
JH
JH
JH
JH
JH
JH
JH
JH
JH
JH
JH
JH
JH
JH
JH
JH
JH
JH
JH
JH
JH
JH
JH
JH
JH
JH
JH
JH
JH
JH
JH
JH
JH
JH
JH
JH
"}
(2,1,3) = {"
JH
JH
JH
JH
JH
JH
JH
JH
JH
JH
JH
JH
JH
JH
JH
JH
JH
JH
JH
JH
JH
JH
JH
JH
JH
JH
JH
JH
JH
JH
JH
JH
JH
JH
JH
JH
JH
JH
JH
JH
JH
JH
JH
JH
JH
JH
JH
JH
JH
JH
JH
JH
"}
(3,1,3) = {"
JH
JH
JH
JH
JH
JH
JH
JH
JH
JH
JH
JH
JH
JH
JH
JH
JH
JH
JH
JH
JH
JH
JH
JH
JH
JH
JH
JH
JH
JH
JH
JH
JH
JH
JH
JH
JH
JH
JH
JH
JH
JH
JH
JH
JH
JH
JH
JH
JH
JH
JH
JH
"}
(4,1,3) = {"
JH
JH
JH
JH
JH
JH
JH
JH
JH
JH
JH
JH
JH
JH
JH
JH
JH
JH
JH
JH
JH
JH
JH
JH
JH
JH
JH
JH
JH
JH
JH
JH
JH
JH
JH
JH
JH
JH
JH
JH
JH
JH
JH
JH
JH
JH
JH
JH
JH
JH
JH
JH
"}
(5,1,3) = {"
JH
JH
JH
JH
JH
JH
JH
JH
JH
JH
JH
JH
JH
JH
JH
JH
JH
JH
JH
JH
JH
JH
JH
JH
JH
JH
JH
JH
JH
JH
JH
JH
JH
JH
JH
JH
JH
JH
JH
JH
JH
JH
JH
JH
JH
JH
JH
JH
JH
JH
JH
JH
"}
(6,1,3) = {"
JH
JH
JH
JH
JH
JH
JH
JH
JH
JH
JH
JH
JH
JH
JH
JH
JH
JH
JH
JH
JH
JH
JH
JH
JH
JH
JH
JH
JH
JH
JH
JH
JH
JH
JH
JH
JH
JH
JH
JH
JH
JH
JH
JH
JH
JH
JH
JH
JH
JH
JH
JH
"}
(7,1,3) = {"
JH
JH
JH
JH
JH
JH
JH
JH
JH
JH
JH
JH
JH
JH
JH
JH
JH
JH
JH
JH
JH
JH
JH
JH
JH
JH
JH
JH
JH
JH
JH
JH
JH
JH
JH
JH
JH
JH
JH
JH
JH
JH
JH
JH
JH
JH
JH
JH
JH
JH
JH
JH
"}
(8,1,3) = {"
JH
JH
JH
JH
JH
JH
JH
JH
JH
JH
JH
JH
JH
JH
JH
JH
JH
JH
JH
JH
JH
JH
JH
JH
JH
JH
JH
JH
JH
JH
JH
JH
JH
JH
JH
JH
JH
JH
JH
JH
JH
JH
JH
JH
JH
JH
JH
JH
JH
JH
JH
JH
"}
(9,1,3) = {"
JH
JH
JH
JH
JH
JH
JH
JH
JH
JH
JH
JH
JH
JH
JH
JH
JH
JH
JH
JH
JH
JH
JH
JH
JH
JH
JH
JH
JH
JH
JH
JH
JH
JH
JH
JH
JH
JH
JH
JH
JH
JH
JH
JH
JH
JH
JH
JH
JH
JH
JH
JH
"}
(10,1,3) = {"
JH
JH
JH
JH
JH
JH
JH
JH
JH
JH
JH
JH
JH
JH
JH
JH
JH
JH
JH
JH
JH
JH
JH
JH
JH
JH
JH
JH
JH
JH
JH
JH
JH
JH
JH
JH
JH
JH
JH
JH
JH
JH
JH
JH
JH
JH
JH
JH
JH
JH
JH
JH
"}
(11,1,3) = {"
JH
JH
JH
JH
JH
JH
JH
JH
JH
JH
JH
JH
JH
JH
JH
JH
JH
JH
JH
JH
JH
JH
JH
JH
JH
JH
JH
JH
JH
JH
JH
JH
JH
JH
JH
JH
JH
JH
JH
JH
JH
JH
JH
JH
JH
JH
JH
JH
JH
JH
JH
JH
"}
(12,1,3) = {"
JH
JH
JH
JH
JH
JH
JH
JH
JH
JH
JH
JH
JH
JH
JH
JH
JH
JH
JH
JH
JH
JH
JH
JH
JH
JH
JH
JH
JH
JH
JH
JH
JH
JH
JH
JH
JH
JH
JH
JH
JH
JH
JH
JH
JH
JH
JH
JH
JH
JH
JH
JH
"}
(13,1,3) = {"
JH
JH
JH
JH
JH
JH
JH
JH
JH
JH
JH
JH
JH
JH
JH
JH
JH
JH
JH
JH
JH
JH
JH
JH
JH
JH
JH
JH
JH
JH
JH
JH
JH
JH
JH
JH
JH
JH
JH
JH
JH
JH
JH
JH
JH
JH
JH
JH
JH
JH
JH
JH
"}
(14,1,3) = {"
JH
JH
JH
JH
JH
JH
JH
JH
JH
JH
JH
JH
JH
JH
JH
JH
JH
JH
JH
JH
JH
JH
JH
JH
JH
JH
JH
JH
JH
JH
JH
JH
JH
JH
JH
JH
JH
JH
JH
JH
JH
JH
JH
JH
JH
JH
JH
JH
JH
JH
JH
JH
"}
(15,1,3) = {"
JH
JH
JH
JH
JH
JH
JH
JH
JH
JH
JH
JH
JH
JH
JH
JH
JH
JH
JH
JH
JH
JH
JH
JH
JH
JH
JH
JH
JH
JH
JH
JH
JH
JH
JH
JH
JH
JH
JH
JH
JH
JH
JH
JH
JH
JH
JH
JH
JH
JH
JH
JH
"}
(16,1,3) = {"
JH
JH
JH
JH
JH
JH
JH
JH
JH
JH
JH
JH
JH
JH
JH
JH
JH
JH
JH
JH
JH
JH
JH
JH
JH
JH
JH
JH
JH
JH
JH
JH
JH
JH
JH
JH
JH
JH
JH
JH
JH
JH
JH
JH
JH
JH
JH
JH
JH
JH
JH
JH
"}
(17,1,3) = {"
JH
JH
JH
JH
JH
JH
JH
JH
JH
JH
JH
JH
JH
JH
JH
JH
JH
JH
JH
JH
JH
JH
JH
JH
JH
JH
JH
JH
JH
JH
JH
JH
JH
JH
JH
JH
JH
JH
JH
JH
JH
JH
JH
JH
JH
JH
JH
JH
JH
JH
JH
JH
"}
(18,1,3) = {"
JH
JH
JH
JH
JH
JH
JH
JH
JH
JH
JH
JH
JH
JH
JH
JH
JH
JH
JH
JH
JH
JH
GG
GG
GG
GG
GG
GG
GG
JH
JH
JH
JH
JH
JH
JH
JH
JH
JH
JH
JH
JH
JH
JH
JH
JH
JH
JH
JH
JH
JH
JH
"}
(19,1,3) = {"
JH
JH
JH
JH
JH
JH
JH
JH
JH
JH
JH
JH
JH
JH
JH
JH
JH
JH
JH
JH
GG
GG
GG
GG
GG
GG
GG
GG
GG
GG
JH
JH
JH
JH
JH
JH
JH
JH
JH
JH
JH
JH
JH
JH
JH
JH
JH
JH
JH
JH
JH
JH
"}
(20,1,3) = {"
JH
JH
JH
JH
JH
JH
JH
JH
JH
JH
JH
JH
JH
JH
JH
JH
JH
JH
JH
GG
GG
GG
GG
GG
GG
GG
GG
GG
GG
GG
GG
JH
JH
JH
JH
JH
JH
JH
JH
JH
JH
JH
JH
JH
JH
JH
JH
JH
JH
JH
JH
JH
"}
(21,1,3) = {"
JH
JH
JH
JH
JH
JH
JH
JH
JH
JH
JH
JH
JH
JH
JH
JH
JH
JH
GG
GG
GG
GG
GG
GG
GG
GG
GG
GG
GG
GG
GG
GG
JH
JH
JH
JH
JH
JH
JH
JH
JH
JH
JH
JH
JH
JH
JH
JH
JH
JH
JH
JH
"}
(22,1,3) = {"
JH
JH
JH
JH
JH
JH
JH
JH
JH
JH
JH
JH
JH
JH
JH
JH
JH
JH
GG
GG
GG
GG
GG
GG
GG
GG
GG
GG
GG
GG
GG
GG
JH
JH
JH
JH
JH
JH
JH
JH
JH
JH
JH
JH
JH
JH
JH
JH
JH
JH
JH
JH
"}
(23,1,3) = {"
JH
JH
JH
JH
JH
JH
JH
JH
JH
JH
JH
JH
JH
JH
JH
JH
JH
JH
GG
GG
GG
GG
GG
GG
GG
GG
GG
GG
GG
GG
GG
GG
JH
JH
JH
JH
JH
JH
JH
JH
JH
JH
JH
JH
JH
JH
JH
JH
JH
JH
JH
JH
"}
(24,1,3) = {"
JH
JH
JH
JH
JH
JH
JH
JH
JH
JH
JH
JH
JH
JH
JH
JH
JH
JH
GG
GG
GG
GG
GG
GG
GG
GG
GG
GG
GG
GG
GG
GG
GG
JH
JH
JH
JH
JH
JH
JH
JH
JH
JH
JH
JH
JH
JH
JH
JH
JH
JH
JH
"}
(25,1,3) = {"
JH
JH
JH
JH
JH
JH
JH
JH
JH
JH
JH
JH
JH
JH
JH
JH
JH
JH
GG
GG
GG
GG
GG
GG
GG
GG
GG
GG
GG
GG
GG
GG
GG
JH
JH
JH
JH
JH
JH
JH
JH
JH
JH
JH
JH
JH
JH
JH
JH
JH
JH
JH
"}
(26,1,3) = {"
JH
JH
JH
JH
JH
JH
JH
JH
JH
JH
JH
JH
JH
JH
JH
JH
JH
JH
GG
GG
GG
GG
GG
GG
GG
GG
GG
GG
GG
GG
GG
GG
GG
JH
JH
JH
JH
xO
JH
JH
JH
JH
JH
JH
JH
JH
JH
JH
JH
JH
JH
JH
"}
(27,1,3) = {"
JH
JH
JH
JH
JH
JH
JH
JH
JH
JH
JH
JH
JH
JH
JH
JH
JH
JH
GG
GG
GG
GG
GG
GG
GG
GG
GG
GG
GG
GG
GG
GG
GG
JH
JH
JH
JH
xO
JH
JH
JH
JH
JH
JH
JH
JH
JH
JH
JH
JH
JH
JH
"}
(28,1,3) = {"
JH
JH
JH
JH
JH
JH
JH
JH
JH
JH
JH
JH
JH
JH
JH
JH
JH
JH
GG
GG
GG
GG
GG
GG
GG
GG
GG
GG
GG
GG
GG
GG
GG
JH
JH
JH
JH
xO
JH
JH
JH
JH
JH
JH
JH
JH
JH
JH
JH
JH
JH
JH
"}
(29,1,3) = {"
JH
JH
JH
JH
JH
JH
JH
JH
JH
JH
JH
JH
JH
JH
JH
JH
JH
JH
JH
GG
GG
GG
GG
GG
GG
GG
GG
GG
GG
GG
GG
GG
GG
JH
JH
JH
JH
JH
JH
JH
JH
JH
JH
JH
JH
JH
JH
JH
JH
JH
JH
JH
"}
(30,1,3) = {"
JH
JH
JH
JH
JH
JH
JH
JH
JH
JH
JH
JH
JH
JH
JH
JH
JH
JH
JH
JH
GG
GG
GG
GG
GG
GG
GG
GG
GG
GG
GG
GG
GG
JH
JH
JH
JH
JH
JH
JH
JH
JH
JH
JH
JH
JH
JH
JH
JH
JH
JH
JH
"}
(31,1,3) = {"
JH
JH
JH
JH
JH
JH
JH
JH
JH
JH
JH
JH
JH
JH
JH
JH
JH
JH
JH
JH
GG
GG
GG
GG
GG
GG
GG
GG
GG
GG
GG
GG
JH
JH
JH
JH
JH
JH
JH
JH
JH
JH
JH
JH
JH
JH
JH
JH
JH
JH
JH
JH
"}
(32,1,3) = {"
JH
JH
JH
JH
JH
JH
JH
JH
JH
JH
JH
JH
JH
JH
JH
JH
JH
JH
JH
JH
JH
JH
GG
GG
GG
GG
GG
GG
GG
GG
GG
JH
JH
JH
JH
JH
JH
JH
JH
JH
JH
JH
JH
JH
JH
JH
JH
JH
JH
JH
JH
JH
"}
(33,1,3) = {"
JH
JH
JH
JH
JH
JH
JH
JH
JH
JH
JH
JH
JH
JH
JH
JH
JH
JH
JH
JH
JH
JH
JH
GG
GG
GG
GG
GG
GG
GG
JH
JH
JH
JH
JH
JH
JH
JH
JH
JH
JH
JH
JH
JH
JH
JH
JH
JH
JH
JH
JH
JH
"}
(34,1,3) = {"
JH
JH
JH
JH
JH
JH
JH
JH
JH
JH
JH
JH
JH
JH
JH
JH
JH
JH
JH
JH
JH
JH
JH
JH
JH
JH
GG
GG
JH
JH
JH
JH
JH
JH
JH
JH
JH
JH
JH
JH
JH
JH
JH
JH
JH
JH
JH
JH
JH
JH
JH
JH
"}
(35,1,3) = {"
JH
JH
JH
JH
JH
JH
JH
JH
JH
JH
JH
JH
JH
JH
JH
JH
JH
JH
JH
JH
JH
JH
JH
JH
JH
JH
JH
JH
JH
JH
JH
JH
JH
JH
JH
JH
JH
JH
JH
JH
JH
JH
JH
JH
JH
JH
JH
JH
JH
JH
JH
JH
"}
(36,1,3) = {"
JH
JH
JH
JH
JH
JH
JH
JH
JH
JH
JH
JH
JH
JH
JH
JH
JH
JH
JH
JH
JH
JH
JH
JH
JH
JH
JH
JH
JH
JH
JH
JH
JH
JH
JH
JH
JH
JH
JH
JH
JH
JH
JH
JH
JH
JH
JH
JH
JH
JH
JH
JH
"}
(37,1,3) = {"
JH
JH
JH
JH
JH
JH
JH
JH
JH
JH
JH
JH
JH
JH
JH
JH
JH
JH
JH
JH
JH
JH
JH
JH
JH
JH
JH
JH
JH
JH
JH
JH
JH
JH
JH
JH
JH
JH
JH
JH
JH
JH
JH
JH
JH
JH
JH
JH
JH
JH
JH
JH
"}
(38,1,3) = {"
JH
JH
JH
JH
JH
JH
JH
JH
JH
JH
JH
JH
JH
JH
JH
JH
JH
JH
JH
JH
JH
JH
JH
JH
JH
JH
JH
JH
JH
JH
JH
JH
JH
JH
JH
JH
JH
JH
JH
JH
JH
JH
JH
JH
JH
JH
JH
JH
JH
JH
JH
JH
"}
(39,1,3) = {"
JH
JH
JH
JH
JH
JH
JH
JH
JH
JH
JH
JH
JH
JH
JH
JH
JH
JH
JH
JH
JH
JH
JH
JH
JH
JH
JH
JH
JH
JH
JH
JH
JH
JH
JH
JH
JH
JH
JH
JH
JH
JH
JH
JH
JH
JH
JH
JH
JH
JH
JH
JH
"}
(40,1,3) = {"
JH
JH
JH
JH
JH
JH
JH
JH
JH
JH
JH
JH
JH
JH
JH
JH
JH
JH
JH
JH
JH
JH
JH
JH
JH
JH
JH
JH
JH
JH
JH
JH
JH
JH
JH
JH
JH
JH
JH
JH
JH
JH
JH
JH
JH
JH
JH
JH
JH
JH
JH
JH
"}
(41,1,3) = {"
JH
JH
JH
JH
JH
JH
JH
JH
JH
JH
JH
JH
JH
JH
JH
JH
JH
JH
JH
JH
JH
JH
JH
JH
JH
JH
JH
JH
JH
JH
JH
JH
JH
JH
JH
JH
JH
JH
JH
JH
JH
JH
JH
JH
JH
JH
JH
JH
JH
JH
JH
JH
"}
(42,1,3) = {"
JH
JH
JH
JH
JH
JH
JH
JH
JH
JH
JH
JH
JH
JH
JH
JH
JH
JH
JH
JH
JH
JH
JH
JH
JH
JH
JH
JH
JH
JH
JH
JH
JH
JH
JH
JH
JH
JH
JH
JH
JH
JH
JH
JH
JH
JH
JH
JH
JH
JH
JH
JH
"}
(43,1,3) = {"
JH
JH
JH
JH
JH
JH
JH
JH
JH
JH
JH
JH
JH
JH
JH
JH
JH
JH
JH
JH
JH
JH
JH
JH
JH
JH
JH
JH
JH
JH
JH
JH
JH
JH
JH
JH
JH
JH
JH
JH
JH
JH
JH
JH
JH
JH
JH
JH
JH
JH
JH
JH
"}
(44,1,3) = {"
JH
JH
JH
JH
JH
JH
JH
JH
JH
JH
JH
JH
JH
JH
JH
JH
JH
JH
JH
JH
JH
JH
JH
JH
JH
JH
JH
JH
JH
JH
JH
JH
JH
JH
JH
JH
JH
JH
JH
JH
JH
JH
JH
JH
JH
JH
JH
JH
JH
JH
JH
JH
"}
(45,1,3) = {"
JH
JH
JH
JH
JH
JH
JH
JH
JH
JH
JH
JH
JH
JH
JH
JH
JH
JH
JH
JH
JH
JH
JH
JH
JH
JH
JH
JH
JH
JH
JH
JH
JH
JH
JH
JH
JH
JH
JH
JH
JH
JH
JH
JH
JH
JH
JH
JH
JH
JH
JH
JH
"}
(46,1,3) = {"
JH
JH
JH
JH
JH
JH
JH
JH
JH
JH
JH
JH
JH
JH
JH
JH
JH
JH
JH
JH
JH
JH
JH
JH
JH
JH
JH
JH
JH
JH
JH
JH
JH
JH
JH
JH
JH
JH
JH
JH
JH
JH
JH
JH
JH
JH
JH
JH
JH
JH
JH
JH
"}
(47,1,3) = {"
JH
JH
JH
JH
JH
JH
JH
JH
JH
JH
JH
JH
JH
JH
JH
JH
JH
JH
JH
JH
JH
JH
JH
JH
JH
JH
JH
JH
JH
JH
JH
JH
JH
JH
JH
JH
JH
JH
JH
JH
JH
JH
JH
JH
JH
JH
JH
JH
JH
JH
JH
JH
"}
(48,1,3) = {"
JH
JH
JH
JH
JH
JH
JH
JH
JH
JH
JH
JH
JH
JH
JH
JH
JH
JH
JH
JH
JH
JH
JH
JH
JH
JH
JH
JH
JH
JH
JH
JH
JH
JH
JH
JH
JH
JH
JH
JH
JH
JH
JH
JH
JH
JH
JH
JH
JH
JH
JH
JH
"}
(49,1,3) = {"
JH
JH
JH
JH
JH
JH
JH
JH
JH
JH
JH
JH
JH
JH
JH
JH
JH
JH
JH
JH
JH
JH
JH
JH
JH
JH
JH
JH
JH
JH
JH
JH
JH
JH
JH
JH
JH
JH
JH
JH
JH
JH
JH
JH
JH
JH
JH
JH
JH
JH
JH
JH
"}
(50,1,3) = {"
JH
JH
JH
JH
JH
JH
JH
JH
JH
JH
JH
JH
JH
JH
JH
JH
JH
JH
JH
JH
JH
JH
JH
JH
JH
JH
JH
JH
JH
JH
JH
JH
JH
JH
JH
JH
JH
JH
JH
JH
JH
JH
JH
JH
JH
JH
JH
JH
JH
JH
JH
JH
"}
(51,1,3) = {"
JH
JH
JH
JH
JH
JH
JH
JH
JH
JH
JH
JH
JH
JH
JH
JH
JH
JH
JH
JH
JH
JH
JH
JH
JH
JH
JH
JH
JH
JH
JH
JH
JH
JH
JH
JH
JH
JH
JH
JH
JH
JH
JH
JH
JH
JH
JH
JH
JH
JH
JH
JH
"}
(52,1,3) = {"
JH
JH
JH
JH
JH
JH
JH
JH
JH
JH
JH
JH
JH
JH
JH
JH
JH
JH
JH
JH
JH
JH
JH
JH
JH
JH
JH
JH
JH
JH
JH
JH
JH
JH
JH
JH
JH
JH
JH
JH
JH
JH
JH
JH
JH
JH
JH
JH
JH
JH
JH
JH
"}
