//MAP CONVERTED BY dmm2tgm.py THIS HEADER COMMENT PREVENTS RECONVERSION, DO NOT REMOVE
"bd" = (
/turf/closed/mineral/asteroid{
	initial_gas_mix = "o2=22;n2=82;TEMP=293.15";
	baseturfs = /turf/open/misc/asteroid
	},
/area/df_event/underground)
"dY" = (
/obj/structure/stairs/south,
/turf/open/misc/asteroid,
/area/df_event/underground)
"em" = (
/turf/open/openspace,
/area/df_event/underground)
"eI" = (
/turf/closed/mineral/ash_rock{
	baseturfs = /turf/open/misc/asteroid;
	initial_gas_mix = "o2=22;n2=82;TEMP=293.15"
	},
/area/df_event/underground)
"kO" = (
/turf/closed/indestructible/hotelwall,
/area/df_event)
"xO" = (
/obj/effect/landmark/latejoin,
/turf/open/misc/grass/planet,
/area/df_event)
"GG" = (
/turf/open/openspace,
/area/df_event)
"JH" = (
/turf/open/misc/grass/planet,
/area/df_event)
"RQ" = (
/turf/open/misc/asteroid,
/area/df_event/underground)
"Vi" = (
/turf/closed/indestructible/hotelwall,
/area/df_event/underground)

(1,1,1) = {"
Vi
Vi
Vi
Vi
Vi
Vi
Vi
Vi
Vi
Vi
Vi
Vi
Vi
Vi
Vi
Vi
Vi
Vi
Vi
Vi
Vi
Vi
Vi
Vi
Vi
Vi
Vi
Vi
Vi
Vi
Vi
Vi
Vi
Vi
Vi
Vi
Vi
Vi
Vi
Vi
Vi
Vi
Vi
Vi
Vi
Vi
Vi
Vi
Vi
Vi
Vi
Vi
"}
(2,1,1) = {"
Vi
bd
bd
bd
bd
bd
bd
bd
bd
bd
bd
bd
bd
bd
bd
bd
bd
bd
bd
bd
bd
bd
bd
bd
bd
bd
bd
bd
bd
bd
bd
bd
bd
bd
bd
bd
bd
bd
bd
bd
bd
bd
bd
bd
bd
bd
bd
bd
bd
bd
bd
Vi
"}
(3,1,1) = {"
Vi
bd
bd
bd
bd
bd
bd
bd
bd
bd
bd
bd
bd
bd
bd
bd
bd
bd
bd
bd
bd
bd
bd
bd
bd
bd
bd
bd
bd
bd
bd
bd
bd
bd
bd
bd
bd
bd
bd
bd
bd
bd
bd
bd
bd
bd
bd
bd
bd
bd
bd
Vi
"}
(4,1,1) = {"
Vi
bd
bd
bd
bd
bd
bd
bd
bd
bd
bd
bd
bd
bd
bd
bd
bd
bd
bd
bd
bd
bd
bd
bd
bd
bd
bd
bd
bd
bd
bd
bd
bd
bd
bd
bd
bd
bd
bd
bd
bd
bd
bd
bd
bd
bd
bd
bd
bd
bd
bd
Vi
"}
(5,1,1) = {"
Vi
bd
bd
bd
bd
bd
bd
bd
bd
bd
bd
bd
bd
bd
bd
bd
bd
bd
bd
bd
bd
bd
bd
bd
bd
bd
bd
bd
bd
bd
bd
bd
bd
bd
bd
bd
bd
bd
bd
bd
bd
bd
bd
bd
bd
bd
bd
bd
bd
bd
bd
Vi
"}
(6,1,1) = {"
Vi
bd
bd
bd
bd
bd
bd
bd
bd
bd
bd
bd
bd
bd
bd
bd
bd
bd
bd
bd
bd
bd
bd
bd
bd
bd
bd
bd
bd
bd
bd
bd
bd
bd
bd
bd
bd
bd
bd
bd
bd
bd
bd
bd
bd
bd
bd
bd
bd
bd
bd
Vi
"}
(7,1,1) = {"
Vi
bd
bd
bd
bd
bd
bd
bd
bd
bd
bd
bd
bd
bd
bd
bd
bd
bd
bd
bd
bd
bd
bd
bd
bd
bd
bd
bd
bd
bd
bd
bd
bd
bd
bd
bd
bd
bd
bd
bd
bd
bd
bd
bd
bd
bd
bd
bd
bd
bd
bd
Vi
"}
(8,1,1) = {"
Vi
bd
bd
bd
bd
bd
bd
bd
bd
bd
bd
bd
bd
bd
bd
bd
bd
bd
bd
bd
bd
bd
bd
bd
bd
bd
bd
bd
bd
bd
bd
bd
bd
bd
bd
bd
bd
bd
bd
bd
bd
bd
bd
bd
bd
bd
bd
bd
bd
bd
bd
Vi
"}
(9,1,1) = {"
Vi
bd
bd
bd
bd
bd
bd
bd
bd
bd
bd
bd
bd
bd
bd
bd
bd
bd
bd
bd
bd
bd
bd
bd
bd
bd
bd
bd
bd
bd
bd
bd
bd
bd
bd
bd
bd
bd
bd
bd
bd
bd
bd
bd
bd
bd
bd
bd
bd
bd
bd
Vi
"}
(10,1,1) = {"
Vi
bd
bd
bd
bd
bd
bd
bd
bd
bd
bd
bd
bd
bd
bd
bd
bd
bd
bd
bd
bd
bd
bd
bd
bd
bd
bd
bd
bd
bd
bd
bd
bd
bd
bd
bd
bd
bd
bd
bd
bd
bd
bd
bd
bd
bd
bd
bd
bd
bd
bd
Vi
"}
(11,1,1) = {"
Vi
bd
bd
bd
bd
bd
bd
bd
bd
bd
bd
bd
bd
bd
bd
bd
bd
bd
bd
bd
bd
bd
bd
bd
bd
bd
bd
bd
bd
bd
bd
bd
bd
bd
bd
bd
bd
bd
bd
bd
bd
bd
bd
bd
bd
bd
bd
bd
bd
bd
bd
Vi
"}
(12,1,1) = {"
Vi
bd
bd
bd
bd
bd
bd
bd
bd
bd
bd
bd
bd
bd
bd
bd
bd
bd
bd
bd
bd
bd
bd
bd
bd
bd
bd
bd
bd
bd
bd
bd
bd
bd
bd
bd
bd
bd
bd
bd
bd
bd
bd
bd
bd
bd
bd
bd
bd
bd
bd
Vi
"}
(13,1,1) = {"
Vi
bd
bd
bd
bd
bd
bd
bd
bd
bd
bd
bd
bd
bd
bd
bd
bd
bd
bd
bd
bd
bd
bd
bd
bd
bd
bd
bd
bd
bd
bd
bd
bd
bd
bd
bd
bd
bd
bd
bd
bd
bd
bd
bd
bd
bd
bd
bd
bd
bd
bd
Vi
"}
(14,1,1) = {"
Vi
bd
bd
bd
bd
bd
bd
bd
bd
bd
bd
bd
bd
bd
bd
bd
bd
bd
bd
bd
bd
bd
bd
bd
bd
bd
bd
bd
bd
bd
bd
bd
bd
bd
bd
bd
bd
bd
bd
bd
bd
bd
bd
bd
bd
bd
bd
bd
bd
bd
bd
Vi
"}
(15,1,1) = {"
Vi
bd
bd
bd
bd
bd
bd
bd
bd
bd
bd
bd
bd
bd
bd
bd
bd
bd
bd
bd
bd
bd
RQ
RQ
RQ
RQ
RQ
RQ
RQ
RQ
bd
bd
bd
bd
bd
bd
bd
bd
bd
bd
bd
bd
bd
bd
bd
bd
bd
bd
bd
bd
bd
Vi
"}
(16,1,1) = {"
Vi
bd
bd
bd
bd
bd
bd
bd
bd
bd
bd
bd
bd
bd
bd
bd
bd
bd
bd
bd
RQ
RQ
RQ
RQ
RQ
RQ
RQ
RQ
RQ
RQ
RQ
RQ
bd
bd
bd
bd
bd
bd
bd
bd
bd
bd
bd
bd
bd
bd
bd
bd
bd
bd
bd
Vi
"}
(17,1,1) = {"
Vi
bd
bd
bd
bd
bd
bd
bd
bd
bd
bd
bd
bd
bd
bd
bd
bd
bd
bd
RQ
RQ
RQ
RQ
RQ
RQ
RQ
RQ
RQ
RQ
RQ
RQ
RQ
bd
bd
bd
bd
bd
bd
bd
bd
bd
bd
bd
bd
bd
bd
bd
bd
bd
bd
bd
Vi
"}
(18,1,1) = {"
Vi
bd
bd
bd
bd
bd
bd
bd
bd
bd
bd
bd
bd
bd
bd
bd
bd
bd
bd
RQ
RQ
RQ
RQ
RQ
RQ
RQ
RQ
RQ
RQ
RQ
RQ
RQ
RQ
bd
bd
bd
bd
bd
bd
bd
bd
bd
bd
bd
bd
bd
bd
bd
bd
bd
bd
Vi
"}
(19,1,1) = {"
Vi
bd
bd
bd
bd
bd
bd
bd
bd
bd
bd
bd
bd
bd
bd
bd
bd
bd
bd
RQ
RQ
RQ
RQ
RQ
RQ
RQ
RQ
RQ
RQ
RQ
RQ
RQ
RQ
bd
bd
bd
bd
bd
bd
bd
bd
bd
bd
bd
bd
bd
bd
bd
bd
bd
bd
Vi
"}
(20,1,1) = {"
Vi
bd
bd
bd
bd
bd
bd
bd
bd
bd
bd
bd
bd
bd
bd
bd
bd
bd
bd
RQ
RQ
RQ
RQ
RQ
RQ
RQ
RQ
RQ
RQ
RQ
RQ
RQ
RQ
RQ
bd
bd
bd
bd
bd
bd
bd
bd
bd
bd
bd
bd
bd
bd
bd
bd
bd
Vi
"}
(21,1,1) = {"
Vi
bd
bd
bd
bd
bd
bd
bd
bd
bd
bd
bd
bd
bd
bd
bd
bd
bd
RQ
RQ
RQ
RQ
RQ
RQ
RQ
RQ
RQ
RQ
RQ
RQ
RQ
RQ
RQ
RQ
bd
bd
bd
bd
bd
bd
bd
bd
bd
bd
bd
bd
bd
bd
bd
bd
bd
Vi
"}
(22,1,1) = {"
Vi
bd
bd
bd
bd
bd
bd
bd
bd
bd
bd
bd
bd
bd
bd
bd
bd
bd
RQ
RQ
RQ
RQ
RQ
RQ
RQ
RQ
RQ
RQ
RQ
RQ
RQ
RQ
RQ
RQ
bd
bd
bd
bd
bd
bd
bd
bd
bd
bd
bd
bd
bd
bd
bd
bd
bd
Vi
"}
(23,1,1) = {"
Vi
bd
bd
bd
bd
bd
bd
bd
bd
bd
bd
bd
bd
bd
bd
bd
bd
bd
RQ
RQ
RQ
RQ
RQ
RQ
RQ
RQ
RQ
RQ
RQ
RQ
RQ
RQ
RQ
RQ
bd
bd
bd
bd
bd
bd
bd
bd
bd
bd
bd
bd
bd
bd
bd
bd
bd
Vi
"}
(24,1,1) = {"
Vi
bd
bd
bd
bd
bd
bd
bd
bd
bd
bd
bd
bd
bd
bd
bd
bd
bd
RQ
RQ
RQ
RQ
RQ
RQ
RQ
RQ
RQ
RQ
RQ
RQ
RQ
RQ
RQ
RQ
bd
bd
bd
bd
bd
bd
bd
bd
bd
bd
bd
bd
bd
bd
bd
bd
bd
Vi
"}
(25,1,1) = {"
Vi
bd
bd
bd
bd
bd
bd
bd
bd
bd
bd
bd
bd
bd
bd
bd
bd
bd
RQ
RQ
RQ
RQ
RQ
RQ
RQ
RQ
RQ
RQ
RQ
RQ
RQ
RQ
RQ
RQ
RQ
bd
bd
bd
bd
bd
bd
bd
bd
bd
bd
bd
bd
bd
bd
bd
bd
Vi
"}
(26,1,1) = {"
Vi
bd
bd
bd
bd
bd
bd
bd
bd
bd
bd
bd
bd
bd
bd
bd
bd
bd
RQ
RQ
RQ
RQ
RQ
RQ
RQ
RQ
RQ
RQ
RQ
RQ
RQ
RQ
RQ
RQ
RQ
bd
bd
bd
bd
bd
bd
bd
bd
bd
bd
bd
bd
bd
bd
bd
bd
Vi
"}
(27,1,1) = {"
Vi
bd
bd
bd
bd
bd
bd
bd
bd
bd
bd
bd
bd
bd
bd
bd
bd
bd
RQ
RQ
RQ
RQ
RQ
RQ
RQ
RQ
RQ
RQ
RQ
RQ
RQ
dY
RQ
RQ
RQ
bd
bd
bd
bd
bd
bd
bd
bd
bd
bd
bd
bd
bd
bd
bd
bd
Vi
"}
(28,1,1) = {"
Vi
bd
bd
bd
bd
bd
bd
bd
bd
bd
bd
bd
bd
bd
bd
bd
bd
bd
bd
RQ
RQ
RQ
RQ
RQ
RQ
RQ
RQ
RQ
RQ
RQ
RQ
RQ
RQ
RQ
RQ
bd
bd
bd
bd
bd
bd
bd
bd
bd
bd
bd
bd
bd
bd
bd
bd
Vi
"}
(29,1,1) = {"
Vi
bd
bd
bd
bd
bd
bd
bd
bd
bd
bd
bd
bd
bd
bd
bd
bd
bd
bd
RQ
RQ
RQ
RQ
RQ
RQ
RQ
RQ
RQ
RQ
RQ
RQ
RQ
RQ
RQ
RQ
bd
bd
bd
bd
bd
bd
bd
bd
bd
bd
bd
bd
bd
bd
bd
bd
Vi
"}
(30,1,1) = {"
Vi
bd
bd
bd
bd
bd
bd
bd
bd
bd
bd
bd
bd
bd
bd
bd
bd
bd
bd
bd
RQ
RQ
RQ
RQ
RQ
RQ
RQ
RQ
RQ
RQ
RQ
RQ
RQ
RQ
RQ
bd
bd
bd
bd
bd
bd
bd
bd
bd
bd
bd
bd
bd
bd
bd
bd
Vi
"}
(31,1,1) = {"
Vi
bd
bd
bd
bd
bd
bd
bd
bd
bd
bd
bd
bd
bd
bd
bd
bd
bd
bd
bd
RQ
RQ
RQ
RQ
RQ
RQ
RQ
RQ
RQ
RQ
RQ
RQ
RQ
RQ
RQ
bd
bd
bd
bd
bd
bd
bd
bd
bd
bd
bd
bd
bd
bd
bd
bd
Vi
"}
(32,1,1) = {"
Vi
bd
bd
bd
bd
bd
bd
bd
bd
bd
bd
bd
bd
bd
bd
bd
bd
bd
bd
bd
bd
RQ
RQ
RQ
RQ
RQ
RQ
RQ
RQ
RQ
RQ
RQ
RQ
RQ
RQ
bd
bd
bd
bd
bd
bd
bd
bd
bd
bd
bd
bd
bd
bd
bd
bd
Vi
"}
(33,1,1) = {"
Vi
bd
bd
bd
bd
bd
bd
bd
bd
bd
bd
bd
bd
bd
bd
bd
bd
bd
bd
bd
bd
bd
RQ
RQ
RQ
RQ
RQ
RQ
RQ
RQ
RQ
RQ
RQ
RQ
bd
bd
bd
bd
bd
bd
bd
bd
bd
bd
bd
bd
bd
bd
bd
bd
bd
Vi
"}
(34,1,1) = {"
Vi
bd
bd
bd
bd
bd
bd
bd
bd
bd
bd
bd
bd
bd
bd
bd
bd
bd
bd
bd
bd
bd
RQ
RQ
RQ
RQ
RQ
RQ
RQ
RQ
RQ
RQ
RQ
RQ
bd
bd
bd
bd
bd
bd
bd
bd
bd
bd
bd
bd
bd
bd
bd
bd
bd
Vi
"}
(35,1,1) = {"
Vi
bd
bd
bd
bd
bd
bd
bd
bd
bd
bd
bd
bd
bd
bd
bd
bd
bd
bd
bd
bd
bd
bd
bd
RQ
RQ
RQ
RQ
RQ
RQ
RQ
RQ
RQ
bd
bd
bd
bd
bd
bd
bd
bd
bd
bd
bd
bd
bd
bd
bd
bd
bd
bd
Vi
"}
(36,1,1) = {"
Vi
bd
bd
bd
bd
bd
bd
bd
bd
bd
bd
bd
bd
bd
bd
bd
bd
bd
bd
bd
bd
bd
bd
bd
bd
RQ
RQ
RQ
RQ
RQ
RQ
RQ
bd
bd
bd
bd
bd
bd
bd
bd
bd
bd
bd
bd
bd
bd
bd
bd
bd
bd
bd
Vi
"}
(37,1,1) = {"
Vi
bd
bd
bd
bd
bd
bd
bd
bd
bd
bd
bd
bd
bd
bd
bd
bd
bd
bd
bd
bd
bd
bd
bd
bd
bd
bd
bd
bd
bd
bd
bd
bd
bd
bd
bd
bd
bd
bd
bd
bd
bd
bd
bd
bd
bd
bd
bd
bd
bd
bd
Vi
"}
(38,1,1) = {"
Vi
bd
bd
bd
bd
bd
bd
bd
bd
bd
bd
bd
bd
bd
bd
bd
bd
bd
bd
bd
bd
bd
bd
bd
bd
bd
bd
bd
bd
bd
bd
bd
bd
bd
bd
bd
bd
bd
bd
bd
bd
bd
bd
bd
bd
bd
bd
bd
bd
bd
bd
Vi
"}
(39,1,1) = {"
Vi
bd
bd
bd
bd
bd
bd
bd
bd
bd
bd
bd
bd
bd
bd
bd
bd
bd
bd
bd
bd
bd
bd
bd
bd
bd
bd
bd
bd
bd
bd
bd
bd
bd
bd
bd
bd
bd
bd
bd
bd
bd
bd
bd
bd
bd
bd
bd
bd
bd
bd
Vi
"}
(40,1,1) = {"
Vi
bd
bd
bd
bd
bd
bd
bd
bd
bd
bd
bd
bd
bd
bd
bd
bd
bd
bd
bd
bd
bd
bd
bd
bd
bd
bd
bd
bd
bd
bd
bd
bd
bd
bd
bd
bd
bd
bd
bd
bd
bd
bd
bd
bd
bd
bd
bd
bd
bd
bd
Vi
"}
(41,1,1) = {"
Vi
bd
bd
bd
bd
bd
bd
bd
bd
bd
bd
bd
bd
bd
bd
bd
bd
bd
bd
bd
bd
bd
bd
bd
bd
bd
bd
bd
bd
bd
bd
bd
bd
bd
bd
bd
bd
bd
bd
bd
bd
bd
bd
bd
bd
bd
bd
bd
bd
bd
bd
Vi
"}
(42,1,1) = {"
Vi
bd
bd
bd
bd
bd
bd
bd
bd
bd
bd
bd
bd
bd
bd
bd
bd
bd
bd
bd
bd
bd
bd
bd
bd
bd
bd
bd
bd
bd
bd
bd
bd
bd
bd
bd
bd
bd
bd
bd
bd
bd
bd
bd
bd
bd
bd
bd
bd
bd
bd
Vi
"}
(43,1,1) = {"
Vi
bd
bd
bd
bd
bd
bd
bd
bd
bd
bd
bd
bd
bd
bd
bd
bd
bd
bd
bd
bd
bd
bd
bd
bd
bd
bd
bd
bd
bd
bd
bd
bd
bd
bd
bd
bd
bd
bd
bd
bd
bd
bd
bd
bd
bd
bd
bd
bd
bd
bd
Vi
"}
(44,1,1) = {"
Vi
bd
bd
bd
bd
bd
bd
bd
bd
bd
bd
bd
bd
bd
bd
bd
bd
bd
bd
bd
bd
bd
bd
bd
bd
bd
bd
bd
bd
bd
bd
bd
bd
bd
bd
bd
bd
bd
bd
bd
bd
bd
bd
bd
bd
bd
bd
bd
bd
bd
bd
Vi
"}
(45,1,1) = {"
Vi
bd
bd
bd
bd
bd
bd
bd
bd
bd
bd
bd
bd
bd
bd
bd
bd
bd
bd
bd
bd
bd
bd
bd
bd
bd
bd
bd
bd
bd
bd
bd
bd
bd
bd
bd
bd
bd
bd
bd
bd
bd
bd
bd
bd
bd
bd
bd
bd
bd
bd
Vi
"}
(46,1,1) = {"
Vi
bd
bd
bd
bd
bd
bd
bd
bd
bd
bd
bd
bd
bd
bd
bd
bd
bd
bd
bd
bd
bd
bd
bd
bd
bd
bd
bd
bd
bd
bd
bd
bd
bd
bd
bd
bd
bd
bd
bd
bd
bd
bd
bd
bd
bd
bd
bd
bd
bd
bd
Vi
"}
(47,1,1) = {"
Vi
bd
bd
bd
bd
bd
bd
bd
bd
bd
bd
bd
bd
bd
bd
bd
bd
bd
bd
bd
bd
bd
bd
bd
bd
bd
bd
bd
bd
bd
bd
bd
bd
bd
bd
bd
bd
bd
bd
bd
bd
bd
bd
bd
bd
bd
bd
bd
bd
bd
bd
Vi
"}
(48,1,1) = {"
Vi
bd
bd
bd
bd
bd
bd
bd
bd
bd
bd
bd
bd
bd
bd
bd
bd
bd
bd
bd
bd
bd
bd
bd
bd
bd
bd
bd
bd
bd
bd
bd
bd
bd
bd
bd
bd
bd
bd
bd
bd
bd
bd
bd
bd
bd
bd
bd
bd
bd
bd
Vi
"}
(49,1,1) = {"
Vi
bd
bd
bd
bd
bd
bd
bd
bd
bd
bd
bd
bd
bd
bd
bd
bd
bd
bd
bd
bd
bd
bd
bd
bd
bd
bd
bd
bd
bd
bd
bd
bd
bd
bd
bd
bd
bd
bd
bd
bd
bd
bd
bd
bd
bd
bd
bd
bd
bd
bd
Vi
"}
(50,1,1) = {"
Vi
bd
bd
bd
bd
bd
bd
bd
bd
bd
bd
bd
bd
bd
bd
bd
bd
bd
bd
bd
bd
bd
bd
bd
bd
bd
bd
bd
bd
bd
bd
bd
bd
bd
bd
bd
bd
bd
bd
bd
bd
bd
bd
bd
bd
bd
bd
bd
bd
bd
bd
Vi
"}
(51,1,1) = {"
Vi
bd
bd
bd
bd
bd
bd
bd
bd
bd
bd
bd
bd
bd
bd
bd
bd
bd
bd
bd
bd
bd
bd
bd
bd
bd
bd
bd
bd
bd
bd
bd
bd
bd
bd
bd
bd
bd
bd
bd
bd
bd
bd
bd
bd
bd
bd
bd
bd
bd
bd
Vi
"}
(52,1,1) = {"
Vi
Vi
Vi
Vi
Vi
Vi
Vi
Vi
Vi
Vi
Vi
Vi
Vi
Vi
Vi
Vi
Vi
Vi
Vi
Vi
Vi
Vi
Vi
Vi
Vi
Vi
Vi
Vi
Vi
Vi
Vi
Vi
Vi
Vi
Vi
Vi
Vi
Vi
Vi
Vi
Vi
Vi
Vi
Vi
Vi
Vi
Vi
Vi
Vi
Vi
Vi
Vi
"}

(1,1,2) = {"
Vi
Vi
Vi
Vi
Vi
Vi
Vi
Vi
Vi
Vi
Vi
Vi
Vi
Vi
Vi
Vi
Vi
Vi
Vi
Vi
Vi
Vi
Vi
Vi
Vi
Vi
Vi
Vi
Vi
Vi
Vi
Vi
Vi
Vi
Vi
Vi
Vi
Vi
Vi
Vi
Vi
Vi
Vi
Vi
Vi
Vi
Vi
Vi
Vi
Vi
Vi
Vi
"}
(2,1,2) = {"
Vi
eI
eI
eI
eI
eI
eI
eI
eI
eI
eI
eI
eI
eI
eI
eI
eI
eI
eI
eI
eI
eI
eI
eI
eI
eI
eI
eI
eI
eI
eI
eI
eI
eI
eI
eI
eI
eI
eI
eI
eI
eI
eI
eI
eI
eI
eI
eI
eI
eI
eI
Vi
"}
(3,1,2) = {"
Vi
eI
eI
eI
eI
eI
eI
eI
eI
eI
eI
eI
eI
eI
eI
eI
eI
eI
eI
eI
eI
eI
eI
eI
eI
eI
eI
eI
eI
eI
eI
eI
eI
eI
eI
eI
eI
eI
eI
eI
eI
eI
eI
eI
eI
eI
eI
eI
eI
eI
eI
Vi
"}
(4,1,2) = {"
Vi
eI
eI
eI
eI
eI
eI
eI
eI
eI
eI
eI
eI
eI
eI
eI
eI
eI
eI
eI
eI
eI
eI
eI
eI
eI
eI
eI
eI
eI
eI
eI
eI
eI
eI
eI
eI
eI
eI
eI
eI
eI
eI
eI
eI
eI
eI
eI
eI
eI
eI
Vi
"}
(5,1,2) = {"
Vi
eI
eI
eI
eI
eI
eI
eI
eI
eI
eI
eI
eI
eI
eI
eI
eI
eI
eI
eI
eI
eI
eI
eI
eI
eI
eI
eI
eI
eI
eI
eI
eI
eI
eI
eI
eI
eI
eI
eI
eI
eI
eI
eI
eI
eI
eI
eI
eI
eI
eI
Vi
"}
(6,1,2) = {"
Vi
eI
eI
eI
eI
eI
eI
eI
eI
eI
eI
eI
eI
eI
eI
eI
eI
eI
eI
eI
eI
eI
eI
eI
eI
eI
eI
eI
eI
eI
eI
eI
eI
eI
eI
eI
eI
eI
eI
eI
eI
eI
eI
eI
eI
eI
eI
eI
eI
eI
eI
Vi
"}
(7,1,2) = {"
Vi
eI
eI
eI
eI
eI
eI
eI
eI
eI
eI
eI
eI
eI
eI
eI
eI
eI
eI
eI
eI
eI
eI
eI
eI
eI
eI
eI
eI
eI
eI
eI
eI
eI
eI
eI
eI
eI
eI
eI
eI
eI
eI
eI
eI
eI
eI
eI
eI
eI
eI
Vi
"}
(8,1,2) = {"
Vi
eI
eI
eI
eI
eI
eI
eI
eI
eI
eI
eI
eI
eI
eI
eI
eI
eI
eI
eI
eI
eI
eI
eI
eI
eI
eI
eI
eI
eI
eI
eI
eI
eI
eI
eI
eI
eI
eI
eI
eI
eI
eI
eI
eI
eI
eI
eI
eI
eI
eI
Vi
"}
(9,1,2) = {"
Vi
eI
eI
eI
eI
eI
eI
eI
eI
eI
eI
eI
eI
eI
eI
eI
eI
eI
eI
eI
eI
eI
eI
eI
eI
eI
eI
eI
eI
eI
eI
eI
eI
eI
eI
eI
eI
eI
eI
eI
eI
eI
eI
eI
eI
eI
eI
eI
eI
eI
eI
Vi
"}
(10,1,2) = {"
Vi
eI
eI
eI
eI
eI
eI
eI
eI
eI
eI
eI
eI
eI
eI
eI
eI
eI
eI
eI
eI
eI
eI
eI
eI
eI
eI
eI
eI
eI
eI
eI
eI
eI
eI
eI
eI
eI
eI
eI
eI
eI
eI
eI
eI
eI
eI
eI
eI
eI
eI
Vi
"}
(11,1,2) = {"
Vi
eI
eI
eI
eI
eI
eI
eI
eI
eI
eI
eI
eI
eI
eI
eI
eI
eI
eI
eI
eI
eI
eI
eI
eI
eI
eI
eI
eI
eI
eI
eI
eI
eI
eI
eI
eI
eI
eI
eI
eI
eI
eI
eI
eI
eI
eI
eI
eI
eI
eI
Vi
"}
(12,1,2) = {"
Vi
eI
eI
eI
eI
eI
eI
eI
eI
eI
eI
eI
eI
eI
eI
eI
eI
eI
eI
eI
eI
eI
eI
eI
eI
eI
eI
eI
eI
eI
eI
eI
eI
eI
eI
eI
eI
eI
eI
eI
eI
eI
eI
eI
eI
eI
eI
eI
eI
eI
eI
Vi
"}
(13,1,2) = {"
Vi
eI
eI
eI
eI
eI
eI
eI
eI
eI
eI
eI
eI
eI
eI
eI
eI
eI
eI
eI
eI
eI
eI
eI
eI
eI
eI
eI
eI
eI
eI
eI
eI
eI
eI
eI
eI
eI
eI
eI
eI
eI
eI
eI
eI
eI
eI
eI
eI
eI
eI
Vi
"}
(14,1,2) = {"
Vi
eI
eI
eI
eI
eI
eI
eI
eI
eI
eI
eI
eI
eI
eI
eI
eI
eI
eI
eI
eI
eI
eI
RQ
RQ
RQ
RQ
RQ
RQ
RQ
RQ
RQ
eI
eI
eI
eI
eI
eI
eI
eI
eI
eI
eI
eI
eI
eI
eI
eI
eI
eI
eI
Vi
"}
(15,1,2) = {"
Vi
eI
eI
eI
eI
eI
eI
eI
eI
eI
eI
eI
eI
eI
eI
eI
eI
eI
eI
eI
RQ
RQ
RQ
RQ
RQ
RQ
RQ
RQ
RQ
RQ
RQ
RQ
RQ
eI
eI
eI
eI
eI
eI
eI
eI
eI
eI
eI
eI
eI
eI
eI
eI
eI
eI
Vi
"}
(16,1,2) = {"
Vi
eI
eI
eI
eI
eI
eI
eI
eI
eI
eI
eI
eI
eI
eI
eI
eI
eI
eI
RQ
RQ
RQ
RQ
RQ
RQ
RQ
RQ
RQ
RQ
RQ
RQ
RQ
RQ
RQ
eI
eI
eI
eI
eI
eI
eI
eI
eI
eI
eI
eI
eI
eI
eI
eI
eI
Vi
"}
(17,1,2) = {"
Vi
eI
eI
eI
eI
eI
eI
eI
eI
eI
eI
eI
eI
eI
eI
eI
eI
eI
eI
RQ
RQ
RQ
RQ
RQ
RQ
RQ
RQ
RQ
RQ
RQ
RQ
RQ
RQ
RQ
eI
eI
eI
eI
eI
eI
eI
eI
eI
eI
eI
eI
eI
eI
eI
eI
eI
Vi
"}
(18,1,2) = {"
Vi
eI
eI
eI
eI
eI
eI
eI
eI
eI
eI
eI
eI
eI
eI
eI
eI
eI
RQ
RQ
RQ
RQ
RQ
RQ
RQ
RQ
RQ
RQ
RQ
RQ
RQ
RQ
RQ
RQ
RQ
eI
eI
eI
eI
eI
eI
eI
eI
eI
eI
eI
eI
eI
eI
eI
eI
Vi
"}
(19,1,2) = {"
Vi
eI
eI
eI
eI
eI
eI
eI
eI
eI
eI
eI
eI
eI
eI
eI
eI
eI
RQ
RQ
RQ
RQ
RQ
RQ
RQ
RQ
RQ
RQ
RQ
RQ
RQ
RQ
RQ
RQ
RQ
RQ
eI
eI
eI
eI
eI
eI
eI
eI
eI
eI
eI
eI
eI
eI
eI
Vi
"}
(20,1,2) = {"
Vi
eI
eI
eI
eI
eI
eI
eI
eI
eI
eI
eI
eI
eI
eI
eI
eI
eI
RQ
RQ
RQ
RQ
RQ
em
em
em
em
em
RQ
RQ
RQ
RQ
RQ
RQ
RQ
RQ
eI
eI
eI
eI
eI
eI
eI
eI
eI
eI
eI
eI
eI
eI
eI
Vi
"}
(21,1,2) = {"
Vi
eI
eI
eI
eI
eI
eI
eI
eI
eI
eI
eI
eI
eI
eI
eI
eI
RQ
RQ
RQ
RQ
RQ
em
em
em
em
em
em
em
RQ
RQ
RQ
RQ
RQ
RQ
RQ
eI
eI
eI
eI
eI
eI
eI
eI
eI
eI
eI
eI
eI
eI
eI
Vi
"}
(22,1,2) = {"
Vi
eI
eI
eI
eI
eI
eI
eI
eI
eI
eI
eI
eI
eI
eI
eI
eI
RQ
RQ
RQ
RQ
RQ
em
em
em
em
em
em
em
em
RQ
RQ
RQ
RQ
RQ
RQ
RQ
eI
eI
eI
eI
eI
eI
eI
eI
eI
eI
eI
eI
eI
eI
Vi
"}
(23,1,2) = {"
Vi
eI
eI
eI
eI
eI
eI
eI
eI
eI
eI
eI
eI
eI
eI
eI
eI
RQ
RQ
RQ
RQ
em
em
em
em
em
em
em
em
em
em
RQ
RQ
RQ
RQ
RQ
RQ
eI
eI
eI
eI
eI
eI
eI
eI
eI
eI
eI
eI
eI
eI
Vi
"}
(24,1,2) = {"
Vi
eI
eI
eI
eI
eI
eI
eI
eI
eI
eI
eI
eI
eI
eI
eI
RQ
RQ
RQ
RQ
RQ
em
em
em
em
em
em
em
em
em
em
RQ
RQ
RQ
RQ
RQ
RQ
eI
eI
eI
eI
eI
eI
eI
eI
eI
eI
eI
eI
eI
eI
Vi
"}
(25,1,2) = {"
Vi
eI
eI
eI
eI
eI
eI
eI
eI
eI
eI
eI
eI
eI
eI
eI
RQ
RQ
RQ
RQ
RQ
em
em
em
em
em
em
em
em
em
em
RQ
RQ
RQ
RQ
RQ
RQ
eI
eI
eI
eI
eI
eI
eI
eI
eI
eI
eI
eI
eI
eI
Vi
"}
(26,1,2) = {"
Vi
eI
eI
eI
eI
eI
eI
eI
eI
eI
eI
eI
eI
eI
eI
eI
RQ
RQ
RQ
RQ
RQ
em
em
em
em
em
em
em
em
em
em
em
RQ
RQ
RQ
RQ
RQ
eI
eI
eI
eI
eI
eI
eI
eI
eI
eI
eI
eI
eI
eI
Vi
"}
(27,1,2) = {"
Vi
eI
eI
eI
eI
eI
eI
eI
eI
eI
eI
eI
eI
eI
eI
eI
RQ
RQ
RQ
RQ
RQ
em
em
em
em
em
em
em
em
em
em
em
dY
RQ
RQ
RQ
RQ
eI
eI
eI
eI
eI
eI
eI
eI
eI
eI
eI
eI
eI
eI
Vi
"}
(28,1,2) = {"
Vi
eI
eI
eI
eI
eI
eI
eI
eI
eI
eI
eI
eI
eI
eI
eI
RQ
RQ
RQ
RQ
RQ
RQ
em
em
em
em
em
em
em
em
em
em
RQ
RQ
RQ
RQ
RQ
eI
eI
eI
eI
eI
eI
eI
eI
eI
eI
eI
eI
eI
eI
Vi
"}
(29,1,2) = {"
Vi
eI
eI
eI
eI
eI
eI
eI
eI
eI
eI
eI
eI
eI
eI
eI
RQ
RQ
RQ
RQ
RQ
RQ
em
em
em
em
em
em
em
em
em
RQ
RQ
RQ
RQ
RQ
RQ
eI
eI
eI
eI
eI
eI
eI
eI
eI
eI
eI
eI
eI
eI
Vi
"}
(30,1,2) = {"
Vi
eI
eI
eI
eI
eI
eI
eI
eI
eI
eI
eI
eI
eI
eI
eI
eI
RQ
RQ
RQ
RQ
RQ
RQ
em
em
em
em
em
em
em
em
RQ
RQ
RQ
RQ
RQ
RQ
eI
eI
eI
eI
eI
eI
eI
eI
eI
eI
eI
eI
eI
eI
Vi
"}
(31,1,2) = {"
Vi
eI
eI
eI
eI
eI
eI
eI
eI
eI
eI
eI
eI
eI
eI
eI
eI
RQ
RQ
RQ
RQ
RQ
RQ
em
em
em
em
em
em
em
RQ
RQ
RQ
RQ
RQ
RQ
RQ
eI
eI
eI
eI
eI
eI
eI
eI
eI
eI
eI
eI
eI
eI
Vi
"}
(32,1,2) = {"
Vi
eI
eI
eI
eI
eI
eI
eI
eI
eI
eI
eI
eI
eI
eI
eI
eI
RQ
RQ
RQ
RQ
RQ
RQ
RQ
RQ
em
em
em
em
RQ
RQ
RQ
RQ
RQ
RQ
RQ
RQ
eI
eI
eI
eI
eI
eI
eI
eI
eI
eI
eI
eI
eI
eI
Vi
"}
(33,1,2) = {"
Vi
eI
eI
eI
eI
eI
eI
eI
eI
eI
eI
eI
eI
eI
eI
eI
eI
eI
RQ
RQ
RQ
RQ
RQ
RQ
RQ
RQ
RQ
RQ
RQ
RQ
RQ
RQ
RQ
RQ
RQ
RQ
RQ
eI
eI
eI
eI
eI
eI
eI
eI
eI
eI
eI
eI
eI
eI
Vi
"}
(34,1,2) = {"
Vi
eI
eI
eI
eI
eI
eI
eI
eI
eI
eI
eI
eI
eI
eI
eI
eI
eI
RQ
RQ
RQ
RQ
RQ
RQ
RQ
RQ
RQ
RQ
RQ
RQ
RQ
RQ
RQ
RQ
RQ
RQ
eI
eI
eI
eI
eI
eI
eI
eI
eI
eI
eI
eI
eI
eI
eI
Vi
"}
(35,1,2) = {"
Vi
eI
eI
eI
eI
eI
eI
eI
eI
eI
eI
eI
eI
eI
eI
eI
eI
eI
eI
RQ
RQ
RQ
RQ
RQ
RQ
RQ
RQ
RQ
RQ
RQ
RQ
RQ
RQ
RQ
RQ
RQ
eI
eI
eI
eI
eI
eI
eI
eI
eI
eI
eI
eI
eI
eI
eI
Vi
"}
(36,1,2) = {"
Vi
eI
eI
eI
eI
eI
eI
eI
eI
eI
eI
eI
eI
eI
eI
eI
eI
eI
eI
eI
RQ
RQ
RQ
RQ
RQ
RQ
RQ
RQ
RQ
RQ
RQ
RQ
RQ
RQ
RQ
RQ
eI
eI
eI
eI
eI
eI
eI
eI
eI
eI
eI
eI
eI
eI
eI
Vi
"}
(37,1,2) = {"
Vi
eI
eI
eI
eI
eI
eI
eI
eI
eI
eI
eI
eI
eI
eI
eI
eI
eI
eI
eI
eI
eI
RQ
RQ
RQ
RQ
RQ
RQ
RQ
RQ
RQ
RQ
RQ
RQ
RQ
eI
eI
eI
eI
eI
eI
eI
eI
eI
eI
eI
eI
eI
eI
eI
eI
Vi
"}
(38,1,2) = {"
Vi
eI
eI
eI
eI
eI
eI
eI
eI
eI
eI
eI
eI
eI
eI
eI
eI
eI
eI
eI
eI
eI
eI
eI
eI
RQ
RQ
RQ
RQ
RQ
RQ
RQ
RQ
eI
eI
eI
eI
eI
eI
eI
eI
eI
eI
eI
eI
eI
eI
eI
eI
eI
eI
Vi
"}
(39,1,2) = {"
Vi
eI
eI
eI
eI
eI
eI
eI
eI
eI
eI
eI
eI
eI
eI
eI
eI
eI
eI
eI
eI
eI
eI
eI
eI
eI
eI
eI
eI
eI
eI
eI
eI
eI
eI
eI
eI
eI
eI
eI
eI
eI
eI
eI
eI
eI
eI
eI
eI
eI
eI
Vi
"}
(40,1,2) = {"
Vi
eI
eI
eI
eI
eI
eI
eI
eI
eI
eI
eI
eI
eI
eI
eI
eI
eI
eI
eI
eI
eI
eI
eI
eI
eI
eI
eI
eI
eI
eI
eI
eI
eI
eI
eI
eI
eI
eI
eI
eI
eI
eI
eI
eI
eI
eI
eI
eI
eI
eI
Vi
"}
(41,1,2) = {"
Vi
eI
eI
eI
eI
eI
eI
eI
eI
eI
eI
eI
eI
eI
eI
eI
eI
eI
eI
eI
eI
eI
eI
eI
eI
eI
eI
eI
eI
eI
eI
eI
eI
eI
eI
eI
eI
eI
eI
eI
eI
eI
eI
eI
eI
eI
eI
eI
eI
eI
eI
Vi
"}
(42,1,2) = {"
Vi
eI
eI
eI
eI
eI
eI
eI
eI
eI
eI
eI
eI
eI
eI
eI
eI
eI
eI
eI
eI
eI
eI
eI
eI
eI
eI
eI
eI
eI
eI
eI
eI
eI
eI
eI
eI
eI
eI
eI
eI
eI
eI
eI
eI
eI
eI
eI
eI
eI
eI
Vi
"}
(43,1,2) = {"
Vi
eI
eI
eI
eI
eI
eI
eI
eI
eI
eI
eI
eI
eI
eI
eI
eI
eI
eI
eI
eI
eI
eI
eI
eI
eI
eI
eI
eI
eI
eI
eI
eI
eI
eI
eI
eI
eI
eI
eI
eI
eI
eI
eI
eI
eI
eI
eI
eI
eI
eI
Vi
"}
(44,1,2) = {"
Vi
eI
eI
eI
eI
eI
eI
eI
eI
eI
eI
eI
eI
eI
eI
eI
eI
eI
eI
eI
eI
eI
eI
eI
eI
eI
eI
eI
eI
eI
eI
eI
eI
eI
eI
eI
eI
eI
eI
eI
eI
eI
eI
eI
eI
eI
eI
eI
eI
eI
eI
Vi
"}
(45,1,2) = {"
Vi
eI
eI
eI
eI
eI
eI
eI
eI
eI
eI
eI
eI
eI
eI
eI
eI
eI
eI
eI
eI
eI
eI
eI
eI
eI
eI
eI
eI
eI
eI
eI
eI
eI
eI
eI
eI
eI
eI
eI
eI
eI
eI
eI
eI
eI
eI
eI
eI
eI
eI
Vi
"}
(46,1,2) = {"
Vi
eI
eI
eI
eI
eI
eI
eI
eI
eI
eI
eI
eI
eI
eI
eI
eI
eI
eI
eI
eI
eI
eI
eI
eI
eI
eI
eI
eI
eI
eI
eI
eI
eI
eI
eI
eI
eI
eI
eI
eI
eI
eI
eI
eI
eI
eI
eI
eI
eI
eI
Vi
"}
(47,1,2) = {"
Vi
eI
eI
eI
eI
eI
eI
eI
eI
eI
eI
eI
eI
eI
eI
eI
eI
eI
eI
eI
eI
eI
eI
eI
eI
eI
eI
eI
eI
eI
eI
eI
eI
eI
eI
eI
eI
eI
eI
eI
eI
eI
eI
eI
eI
eI
eI
eI
eI
eI
eI
Vi
"}
(48,1,2) = {"
Vi
eI
eI
eI
eI
eI
eI
eI
eI
eI
eI
eI
eI
eI
eI
eI
eI
eI
eI
eI
eI
eI
eI
eI
eI
eI
eI
eI
eI
eI
eI
eI
eI
eI
eI
eI
eI
eI
eI
eI
eI
eI
eI
eI
eI
eI
eI
eI
eI
eI
eI
Vi
"}
(49,1,2) = {"
Vi
eI
eI
eI
eI
eI
eI
eI
eI
eI
eI
eI
eI
eI
eI
eI
eI
eI
eI
eI
eI
eI
eI
eI
eI
eI
eI
eI
eI
eI
eI
eI
eI
eI
eI
eI
eI
eI
eI
eI
eI
eI
eI
eI
eI
eI
eI
eI
eI
eI
eI
Vi
"}
(50,1,2) = {"
Vi
eI
eI
eI
eI
eI
eI
eI
eI
eI
eI
eI
eI
eI
eI
eI
eI
eI
eI
eI
eI
eI
eI
eI
eI
eI
eI
eI
eI
eI
eI
eI
eI
eI
eI
eI
eI
eI
eI
eI
eI
eI
eI
eI
eI
eI
eI
eI
eI
eI
eI
Vi
"}
(51,1,2) = {"
Vi
eI
eI
eI
eI
eI
eI
eI
eI
eI
eI
eI
eI
eI
eI
eI
eI
eI
eI
eI
eI
eI
eI
eI
eI
eI
eI
eI
eI
eI
eI
eI
eI
eI
eI
eI
eI
eI
eI
eI
eI
eI
eI
eI
eI
eI
eI
eI
eI
eI
eI
Vi
"}
(52,1,2) = {"
Vi
Vi
Vi
Vi
Vi
Vi
Vi
Vi
Vi
Vi
Vi
Vi
Vi
Vi
Vi
Vi
Vi
Vi
Vi
Vi
Vi
Vi
Vi
Vi
Vi
Vi
Vi
Vi
Vi
Vi
Vi
Vi
Vi
Vi
Vi
Vi
Vi
Vi
Vi
Vi
Vi
Vi
Vi
Vi
Vi
Vi
Vi
Vi
Vi
Vi
Vi
Vi
"}

(1,1,3) = {"
kO
kO
kO
kO
kO
kO
kO
kO
kO
kO
kO
kO
kO
kO
kO
kO
kO
kO
kO
kO
kO
kO
kO
kO
kO
kO
kO
kO
kO
kO
kO
kO
kO
kO
kO
kO
kO
kO
kO
kO
kO
kO
kO
kO
kO
kO
kO
kO
kO
kO
kO
kO
"}
(2,1,3) = {"
kO
JH
JH
JH
JH
JH
JH
JH
JH
JH
JH
JH
JH
JH
JH
JH
JH
JH
JH
JH
JH
JH
JH
JH
JH
JH
JH
JH
JH
JH
JH
JH
JH
JH
JH
JH
JH
JH
JH
JH
JH
JH
JH
JH
JH
JH
JH
JH
JH
JH
JH
kO
"}
(3,1,3) = {"
kO
JH
JH
JH
JH
JH
JH
JH
JH
JH
JH
JH
JH
JH
JH
JH
JH
JH
JH
JH
JH
JH
JH
JH
JH
JH
JH
JH
JH
JH
JH
JH
JH
JH
JH
JH
JH
JH
JH
JH
JH
JH
JH
JH
JH
JH
JH
JH
JH
JH
JH
kO
"}
(4,1,3) = {"
kO
JH
JH
JH
JH
JH
JH
JH
JH
JH
JH
JH
JH
JH
JH
JH
JH
JH
JH
JH
JH
JH
JH
JH
JH
JH
JH
JH
JH
JH
JH
JH
JH
JH
JH
JH
JH
JH
JH
JH
JH
JH
JH
JH
JH
JH
JH
JH
JH
JH
JH
kO
"}
(5,1,3) = {"
kO
JH
JH
JH
JH
JH
JH
JH
JH
JH
JH
JH
JH
JH
JH
JH
JH
JH
JH
JH
JH
JH
JH
JH
JH
JH
JH
JH
JH
JH
JH
JH
JH
JH
JH
JH
JH
JH
JH
JH
JH
JH
JH
JH
JH
JH
JH
JH
JH
JH
JH
kO
"}
(6,1,3) = {"
kO
JH
JH
JH
JH
JH
JH
JH
JH
JH
JH
JH
JH
JH
JH
JH
JH
JH
JH
JH
JH
JH
JH
JH
JH
JH
JH
JH
JH
JH
JH
JH
JH
JH
JH
JH
JH
JH
JH
JH
JH
JH
JH
JH
JH
JH
JH
JH
JH
JH
JH
kO
"}
(7,1,3) = {"
kO
JH
JH
JH
JH
JH
JH
JH
JH
JH
JH
JH
JH
JH
JH
JH
JH
JH
JH
JH
JH
JH
JH
JH
JH
JH
JH
JH
JH
JH
JH
JH
JH
JH
JH
JH
JH
JH
JH
JH
JH
JH
JH
JH
JH
JH
JH
JH
JH
JH
JH
kO
"}
(8,1,3) = {"
kO
JH
JH
JH
JH
JH
JH
JH
JH
JH
JH
JH
JH
JH
JH
JH
JH
JH
JH
JH
JH
JH
JH
JH
JH
JH
JH
JH
JH
JH
JH
JH
JH
JH
JH
JH
JH
JH
JH
JH
JH
JH
JH
JH
JH
JH
JH
JH
JH
JH
JH
kO
"}
(9,1,3) = {"
kO
JH
JH
JH
JH
JH
JH
JH
JH
JH
JH
JH
JH
JH
JH
JH
JH
JH
JH
JH
JH
JH
JH
JH
JH
JH
JH
JH
JH
JH
JH
JH
JH
JH
JH
JH
JH
JH
JH
JH
JH
JH
JH
JH
JH
JH
JH
JH
JH
JH
JH
kO
"}
(10,1,3) = {"
kO
JH
JH
JH
JH
JH
JH
JH
JH
JH
JH
JH
JH
JH
JH
JH
JH
JH
JH
JH
JH
JH
JH
JH
JH
JH
JH
JH
JH
JH
JH
JH
JH
JH
JH
JH
JH
JH
JH
JH
JH
JH
JH
JH
JH
JH
JH
JH
JH
JH
JH
kO
"}
(11,1,3) = {"
kO
JH
JH
JH
JH
JH
JH
JH
JH
JH
JH
JH
JH
JH
JH
JH
JH
JH
JH
JH
JH
JH
JH
JH
JH
JH
JH
JH
JH
JH
JH
JH
JH
JH
JH
JH
JH
JH
JH
JH
JH
JH
JH
JH
JH
JH
JH
JH
JH
JH
JH
kO
"}
(12,1,3) = {"
kO
JH
JH
JH
JH
JH
JH
JH
JH
JH
JH
JH
JH
JH
JH
JH
JH
JH
JH
JH
JH
JH
JH
JH
JH
JH
JH
JH
JH
JH
JH
JH
JH
JH
JH
JH
JH
JH
JH
JH
JH
JH
JH
JH
JH
JH
JH
JH
JH
JH
JH
kO
"}
(13,1,3) = {"
kO
JH
JH
JH
JH
JH
JH
JH
JH
JH
JH
JH
JH
JH
JH
JH
JH
JH
JH
JH
JH
JH
JH
JH
JH
JH
JH
JH
JH
JH
JH
JH
JH
JH
JH
JH
JH
JH
JH
JH
JH
JH
JH
JH
JH
JH
JH
JH
JH
JH
JH
kO
"}
(14,1,3) = {"
kO
JH
JH
JH
JH
JH
JH
JH
JH
JH
JH
JH
JH
JH
JH
JH
JH
JH
JH
JH
JH
JH
JH
JH
JH
JH
JH
JH
JH
JH
JH
JH
JH
JH
JH
JH
JH
JH
JH
JH
JH
JH
JH
JH
JH
JH
JH
JH
JH
JH
JH
kO
"}
(15,1,3) = {"
kO
JH
JH
JH
JH
JH
JH
JH
JH
JH
JH
JH
JH
JH
JH
JH
JH
JH
JH
JH
JH
JH
JH
JH
JH
JH
JH
JH
JH
JH
JH
JH
JH
JH
JH
JH
JH
JH
JH
JH
JH
JH
JH
JH
JH
JH
JH
JH
JH
JH
JH
kO
"}
(16,1,3) = {"
kO
JH
JH
JH
JH
JH
JH
JH
JH
JH
JH
JH
JH
JH
JH
JH
JH
JH
JH
JH
JH
JH
JH
JH
JH
JH
JH
JH
JH
JH
JH
JH
JH
JH
JH
JH
JH
JH
JH
JH
JH
JH
JH
JH
JH
JH
JH
JH
JH
JH
JH
kO
"}
(17,1,3) = {"
kO
JH
JH
JH
JH
JH
JH
JH
JH
JH
JH
JH
JH
JH
JH
JH
JH
JH
JH
JH
JH
JH
JH
JH
JH
JH
JH
JH
JH
JH
JH
JH
JH
JH
JH
JH
JH
JH
JH
JH
JH
JH
JH
JH
JH
JH
JH
JH
JH
JH
JH
kO
"}
(18,1,3) = {"
kO
JH
JH
JH
JH
JH
JH
JH
JH
JH
JH
JH
JH
JH
JH
JH
JH
JH
JH
JH
JH
JH
GG
GG
GG
GG
GG
GG
GG
JH
JH
JH
JH
JH
JH
JH
JH
JH
JH
JH
JH
JH
JH
JH
JH
JH
JH
JH
JH
JH
JH
kO
"}
(19,1,3) = {"
kO
JH
JH
JH
JH
JH
JH
JH
JH
JH
JH
JH
JH
JH
JH
JH
JH
JH
JH
JH
GG
GG
GG
GG
GG
GG
GG
GG
GG
GG
JH
JH
JH
JH
JH
JH
JH
JH
JH
JH
JH
JH
JH
JH
JH
JH
JH
JH
JH
JH
JH
kO
"}
(20,1,3) = {"
kO
JH
JH
JH
JH
JH
JH
JH
JH
JH
JH
JH
JH
JH
JH
JH
JH
JH
JH
GG
GG
GG
GG
GG
GG
GG
GG
GG
GG
GG
GG
JH
JH
JH
JH
JH
JH
JH
JH
JH
JH
JH
JH
JH
JH
JH
JH
JH
JH
JH
JH
kO
"}
(21,1,3) = {"
kO
JH
JH
JH
JH
JH
JH
JH
JH
JH
JH
JH
JH
JH
JH
JH
JH
JH
GG
GG
GG
GG
GG
GG
GG
GG
GG
GG
GG
GG
GG
GG
JH
JH
JH
JH
JH
JH
JH
JH
JH
JH
JH
JH
JH
JH
JH
JH
JH
JH
JH
kO
"}
(22,1,3) = {"
kO
JH
JH
JH
JH
JH
JH
JH
JH
JH
JH
JH
JH
JH
JH
JH
JH
JH
GG
GG
GG
GG
GG
GG
GG
GG
GG
GG
GG
GG
GG
GG
JH
JH
JH
JH
JH
JH
JH
JH
JH
JH
JH
JH
JH
JH
JH
JH
JH
JH
JH
kO
"}
(23,1,3) = {"
kO
JH
JH
JH
JH
JH
JH
JH
JH
JH
JH
JH
JH
JH
JH
JH
JH
JH
GG
GG
GG
GG
GG
GG
GG
GG
GG
GG
GG
GG
GG
GG
JH
JH
JH
JH
JH
JH
JH
JH
JH
JH
JH
JH
JH
JH
JH
JH
JH
JH
JH
kO
"}
(24,1,3) = {"
kO
JH
JH
JH
JH
JH
JH
JH
JH
JH
JH
JH
JH
JH
JH
JH
JH
JH
GG
GG
GG
GG
GG
GG
GG
GG
GG
GG
GG
GG
GG
GG
GG
JH
JH
JH
JH
JH
JH
JH
JH
JH
JH
JH
JH
JH
JH
JH
JH
JH
JH
kO
"}
(25,1,3) = {"
kO
JH
JH
JH
JH
JH
JH
JH
JH
JH
JH
JH
JH
JH
JH
JH
JH
JH
GG
GG
GG
GG
GG
GG
GG
GG
GG
GG
GG
GG
GG
GG
GG
JH
JH
JH
JH
JH
JH
JH
JH
JH
JH
JH
JH
JH
JH
JH
JH
JH
JH
kO
"}
(26,1,3) = {"
kO
JH
JH
JH
JH
JH
JH
JH
JH
JH
JH
JH
JH
JH
JH
JH
JH
JH
GG
GG
GG
GG
GG
GG
GG
GG
GG
GG
GG
GG
GG
GG
GG
JH
JH
JH
JH
xO
JH
JH
JH
JH
JH
JH
JH
JH
JH
JH
JH
JH
JH
kO
"}
(27,1,3) = {"
kO
JH
JH
JH
JH
JH
JH
JH
JH
JH
JH
JH
JH
JH
JH
JH
JH
JH
GG
GG
GG
GG
GG
GG
GG
GG
GG
GG
GG
GG
GG
GG
GG
JH
JH
JH
JH
xO
JH
JH
JH
JH
JH
JH
JH
JH
JH
JH
JH
JH
JH
kO
"}
(28,1,3) = {"
kO
JH
JH
JH
JH
JH
JH
JH
JH
JH
JH
JH
JH
JH
JH
JH
JH
JH
GG
GG
GG
GG
GG
GG
GG
GG
GG
GG
GG
GG
GG
GG
GG
JH
JH
JH
JH
xO
JH
JH
JH
JH
JH
JH
JH
JH
JH
JH
JH
JH
JH
kO
"}
(29,1,3) = {"
kO
JH
JH
JH
JH
JH
JH
JH
JH
JH
JH
JH
JH
JH
JH
JH
JH
JH
JH
GG
GG
GG
GG
GG
GG
GG
GG
GG
GG
GG
GG
GG
GG
JH
JH
JH
JH
JH
JH
JH
JH
JH
JH
JH
JH
JH
JH
JH
JH
JH
JH
kO
"}
(30,1,3) = {"
kO
JH
JH
JH
JH
JH
JH
JH
JH
JH
JH
JH
JH
JH
JH
JH
JH
JH
JH
JH
GG
GG
GG
GG
GG
GG
GG
GG
GG
GG
GG
GG
GG
JH
JH
JH
JH
JH
JH
JH
JH
JH
JH
JH
JH
JH
JH
JH
JH
JH
JH
kO
"}
(31,1,3) = {"
kO
JH
JH
JH
JH
JH
JH
JH
JH
JH
JH
JH
JH
JH
JH
JH
JH
JH
JH
JH
GG
GG
GG
GG
GG
GG
GG
GG
GG
GG
GG
GG
JH
JH
JH
JH
JH
JH
JH
JH
JH
JH
JH
JH
JH
JH
JH
JH
JH
JH
JH
kO
"}
(32,1,3) = {"
kO
JH
JH
JH
JH
JH
JH
JH
JH
JH
JH
JH
JH
JH
JH
JH
JH
JH
JH
JH
JH
JH
GG
GG
GG
GG
GG
GG
GG
GG
GG
JH
JH
JH
JH
JH
JH
JH
JH
JH
JH
JH
JH
JH
JH
JH
JH
JH
JH
JH
JH
kO
"}
(33,1,3) = {"
kO
JH
JH
JH
JH
JH
JH
JH
JH
JH
JH
JH
JH
JH
JH
JH
JH
JH
JH
JH
JH
JH
JH
GG
GG
GG
GG
GG
GG
GG
JH
JH
JH
JH
JH
JH
JH
JH
JH
JH
JH
JH
JH
JH
JH
JH
JH
JH
JH
JH
JH
kO
"}
(34,1,3) = {"
kO
JH
JH
JH
JH
JH
JH
JH
JH
JH
JH
JH
JH
JH
JH
JH
JH
JH
JH
JH
JH
JH
JH
JH
JH
JH
GG
GG
JH
JH
JH
JH
JH
JH
JH
JH
JH
JH
JH
JH
JH
JH
JH
JH
JH
JH
JH
JH
JH
JH
JH
kO
"}
(35,1,3) = {"
kO
JH
JH
JH
JH
JH
JH
JH
JH
JH
JH
JH
JH
JH
JH
JH
JH
JH
JH
JH
JH
JH
JH
JH
JH
JH
JH
JH
JH
JH
JH
JH
JH
JH
JH
JH
JH
JH
JH
JH
JH
JH
JH
JH
JH
JH
JH
JH
JH
JH
JH
kO
"}
(36,1,3) = {"
kO
JH
JH
JH
JH
JH
JH
JH
JH
JH
JH
JH
JH
JH
JH
JH
JH
JH
JH
JH
JH
JH
JH
JH
JH
JH
JH
JH
JH
JH
JH
JH
JH
JH
JH
JH
JH
JH
JH
JH
JH
JH
JH
JH
JH
JH
JH
JH
JH
JH
JH
kO
"}
(37,1,3) = {"
kO
JH
JH
JH
JH
JH
JH
JH
JH
JH
JH
JH
JH
JH
JH
JH
JH
JH
JH
JH
JH
JH
JH
JH
JH
JH
JH
JH
JH
JH
JH
JH
JH
JH
JH
JH
JH
JH
JH
JH
JH
JH
JH
JH
JH
JH
JH
JH
JH
JH
JH
kO
"}
(38,1,3) = {"
kO
JH
JH
JH
JH
JH
JH
JH
JH
JH
JH
JH
JH
JH
JH
JH
JH
JH
JH
JH
JH
JH
JH
JH
JH
JH
JH
JH
JH
JH
JH
JH
JH
JH
JH
JH
JH
JH
JH
JH
JH
JH
JH
JH
JH
JH
JH
JH
JH
JH
JH
kO
"}
(39,1,3) = {"
kO
JH
JH
JH
JH
JH
JH
JH
JH
JH
JH
JH
JH
JH
JH
JH
JH
JH
JH
JH
JH
JH
JH
JH
JH
JH
JH
JH
JH
JH
JH
JH
JH
JH
JH
JH
JH
JH
JH
JH
JH
JH
JH
JH
JH
JH
JH
JH
JH
JH
JH
kO
"}
(40,1,3) = {"
kO
JH
JH
JH
JH
JH
JH
JH
JH
JH
JH
JH
JH
JH
JH
JH
JH
JH
JH
JH
JH
JH
JH
JH
JH
JH
JH
JH
JH
JH
JH
JH
JH
JH
JH
JH
JH
JH
JH
JH
JH
JH
JH
JH
JH
JH
JH
JH
JH
JH
JH
kO
"}
(41,1,3) = {"
kO
JH
JH
JH
JH
JH
JH
JH
JH
JH
JH
JH
JH
JH
JH
JH
JH
JH
JH
JH
JH
JH
JH
JH
JH
JH
JH
JH
JH
JH
JH
JH
JH
JH
JH
JH
JH
JH
JH
JH
JH
JH
JH
JH
JH
JH
JH
JH
JH
JH
JH
kO
"}
(42,1,3) = {"
kO
JH
JH
JH
JH
JH
JH
JH
JH
JH
JH
JH
JH
JH
JH
JH
JH
JH
JH
JH
JH
JH
JH
JH
JH
JH
JH
JH
JH
JH
JH
JH
JH
JH
JH
JH
JH
JH
JH
JH
JH
JH
JH
JH
JH
JH
JH
JH
JH
JH
JH
kO
"}
(43,1,3) = {"
kO
JH
JH
JH
JH
JH
JH
JH
JH
JH
JH
JH
JH
JH
JH
JH
JH
JH
JH
JH
JH
JH
JH
JH
JH
JH
JH
JH
JH
JH
JH
JH
JH
JH
JH
JH
JH
JH
JH
JH
JH
JH
JH
JH
JH
JH
JH
JH
JH
JH
JH
kO
"}
(44,1,3) = {"
kO
JH
JH
JH
JH
JH
JH
JH
JH
JH
JH
JH
JH
JH
JH
JH
JH
JH
JH
JH
JH
JH
JH
JH
JH
JH
JH
JH
JH
JH
JH
JH
JH
JH
JH
JH
JH
JH
JH
JH
JH
JH
JH
JH
JH
JH
JH
JH
JH
JH
JH
kO
"}
(45,1,3) = {"
kO
JH
JH
JH
JH
JH
JH
JH
JH
JH
JH
JH
JH
JH
JH
JH
JH
JH
JH
JH
JH
JH
JH
JH
JH
JH
JH
JH
JH
JH
JH
JH
JH
JH
JH
JH
JH
JH
JH
JH
JH
JH
JH
JH
JH
JH
JH
JH
JH
JH
JH
kO
"}
(46,1,3) = {"
kO
JH
JH
JH
JH
JH
JH
JH
JH
JH
JH
JH
JH
JH
JH
JH
JH
JH
JH
JH
JH
JH
JH
JH
JH
JH
JH
JH
JH
JH
JH
JH
JH
JH
JH
JH
JH
JH
JH
JH
JH
JH
JH
JH
JH
JH
JH
JH
JH
JH
JH
kO
"}
(47,1,3) = {"
kO
JH
JH
JH
JH
JH
JH
JH
JH
JH
JH
JH
JH
JH
JH
JH
JH
JH
JH
JH
JH
JH
JH
JH
JH
JH
JH
JH
JH
JH
JH
JH
JH
JH
JH
JH
JH
JH
JH
JH
JH
JH
JH
JH
JH
JH
JH
JH
JH
JH
JH
kO
"}
(48,1,3) = {"
kO
JH
JH
JH
JH
JH
JH
JH
JH
JH
JH
JH
JH
JH
JH
JH
JH
JH
JH
JH
JH
JH
JH
JH
JH
JH
JH
JH
JH
JH
JH
JH
JH
JH
JH
JH
JH
JH
JH
JH
JH
JH
JH
JH
JH
JH
JH
JH
JH
JH
JH
kO
"}
(49,1,3) = {"
kO
JH
JH
JH
JH
JH
JH
JH
JH
JH
JH
JH
JH
JH
JH
JH
JH
JH
JH
JH
JH
JH
JH
JH
JH
JH
JH
JH
JH
JH
JH
JH
JH
JH
JH
JH
JH
JH
JH
JH
JH
JH
JH
JH
JH
JH
JH
JH
JH
JH
JH
kO
"}
(50,1,3) = {"
kO
JH
JH
JH
JH
JH
JH
JH
JH
JH
JH
JH
JH
JH
JH
JH
JH
JH
JH
JH
JH
JH
JH
JH
JH
JH
JH
JH
JH
JH
JH
JH
JH
JH
JH
JH
JH
JH
JH
JH
JH
JH
JH
JH
JH
JH
JH
JH
JH
JH
JH
kO
"}
(51,1,3) = {"
kO
JH
JH
JH
JH
JH
JH
JH
JH
JH
JH
JH
JH
JH
JH
JH
JH
JH
JH
JH
JH
JH
JH
JH
JH
JH
JH
JH
JH
JH
JH
JH
JH
JH
JH
JH
JH
JH
JH
JH
JH
JH
JH
JH
JH
JH
JH
JH
JH
JH
JH
kO
"}
(52,1,3) = {"
kO
kO
kO
kO
kO
kO
kO
kO
kO
kO
kO
kO
kO
kO
kO
kO
kO
kO
kO
kO
kO
kO
kO
kO
kO
kO
kO
kO
kO
kO
kO
kO
kO
kO
kO
kO
kO
kO
kO
kO
kO
kO
kO
kO
kO
kO
kO
kO
kO
kO
kO
kO
"}
